,Club,League,Nation,Position,Wage,Age,Apps,Caps,Total Apps
0,PSG,Ligue 1 Uber Eats,FRA,Forward,"46,427,000",23,190,57,247
1,PSG,Ligue 1 Uber Eats,BRA,Midfilder,"42,125,000",30,324,119,443
2,PSG,Ligue 1 Uber Eats,ARG,Forward,"34,821,000",35,585,162,747
3,R. Madrid,La Liga,BEL,Forward,"19,959,000",31,443,120,563
4,Man UFC,Premier League,ESP,Goalkeeper,"19,500,000",31,480,45,525
5,R. Madrid,La Liga,AUT,Defender,"18,810,000",30,371,94,465
6,Inter,Serie A,BEL,Forward,"18,200,000",29,427,102,529
7,Liverpool,Premier League,EGY,Forward,"18,200,000",30,367,85,452
8,Chelsea,Premier League,ENG,Midfilder,"18,200,000",27,326,77,403
9,Man UFC,Premier League,FRA,Defender,"18,200,000",29,287,86,373
10,Man City,Premier League,BEL,Midfilder,"17,680,000",31,399,91,490
11,Man City,Premier League,NOR,Forward,"17,680,000",22,159,21,180
12,R. Madrid,La Liga,GER,Midfilder,"16,121,000",32,433,105,538
13,A. Madrid,La Liga,SVN,Goalkeeper,"15,965,000",29,368,50,418
14,Chelsea,Premier League,SEN,Defender,"15,600,000",31,347,61,408
15,Man UFC,Premier League,BRA,Midfilder,"15,600,000",30,328,63,391
16,FC Bayern,Bundesliga,SEN,Forward,"15,476,000",30,355,87,442
17,Barcelona,La Liga,POL,Forward,"15,476,000",34,506,132,638
18,Chelsea,Premier League,FRA,Midfilder,"15,080,000",31,350,53,403
19,FC Bayern,Bundesliga,GER,Midfilder,"15,046,000",32,457,115,572
20,FC Bayern,Bundesliga,GER,Defender,"15,046,000",27,260,68,328
21,FC Bayern,Bundesliga,GER,Midfilder,"14,616,000",26,205,45,250
22,FC Bayern,Bundesliga,GER,Goalkeeper,"14,616,000",36,496,112,608
23,R. Madrid,La Liga,FRA,Forward,"14,432,000",34,532,97,629
24,R. Madrid,La Liga,CRO,Midfilder,"14,432,000",36,560,152,712
25,Man UFC,Premier League,ENG,Midfilder,"14,300,000",22,141,23,164
26,Man City,Premier League,ENG,Midfilder,"14,040,000",26,254,23,277
27,FC Bayern,Bundesliga,NED,Defender,"13,756,000",23,188,37,225
28,A. Madrid,La Liga,ESP,Midfilder,"13,747,000",30,456,66,522
29,A. Madrid,La Liga,ESP,Midfilder,"13,333,000",27,349,19,368
30,R. Madrid,La Liga,BEL,Goalkeeper,"13,272,000",30,418,94,512
31,Man UFC,Premier League,FRA,Forward,"13,000,000",26,236,30,266
32,Man UFC,Premier League,POR,Midfilder,"13,000,000",27,313,46,359
33,Chelsea,Premier League,ENG,Defender,"13,000,000",22,133,13,146
34,FC Bayern,Bundesliga,GER,Midfilder,"12,896,000",27,190,34,224
35,FC Bayern,Bundesliga,FRA,Midfilder,"12,896,000",26,181,40,221
36,Liverpool,Premier League,NED,Defender,"12,480,000",31,334,47,381
37,PSG,Ligue 1 Uber Eats,ITA,Midfilder,"12,381,000",29,327,49,376
38,PSG,Ligue 1 Uber Eats,BRA,Defender,"12,381,000",28,273,69,342
39,Barcelona,La Liga,NED,Defender,"12,070,000",25,207,43,250
40,A. Madrid,La Liga,FRA,Forward,"12,037,000",31,462,108,570
41,FC Bayern,Bundesliga,GER,Midfilder,"12,037,000",27,252,44,296
42,Chelsea,Premier League,FRA,Defender,"11,960,000",21,55,0,55
43,PSG,Ligue 1 Uber Eats,ESP,Defender,"11,710,000",36,547,180,727
44,Liverpool,Premier League,ESP,Midfilder,"11,700,000",31,318,46,364
45,Man UFC,Premier League,ENG,Forward,"11,700,000",24,210,46,256
46,Tottenham,Premier League,ENG,Forward,"11,440,000",29,341,73,414
47,FC Bayern,Bundesliga,POR,Defender,"11,440,000",28,264,36,300
48,PSG,Ligue 1 Uber Eats,ITA,Goalkeeper,"11,177,000",23,239,46,285
49,FC Bayern,Bundesliga,FRA,Defender,"11,177,000",26,155,32,187
50,Juventus,Serie A,SRB,Forward,"11,173,000",22,138,14,152
51,R. Madrid,La Liga,GER,Defender,"10,973,000",29,282,53,335
52,Man City,Premier League,ENG,Defender,"10,400,000",28,225,58,283
53,Man UFC,Premier League,ENG,Defender,"10,400,000",29,374,46,420
54,Man City,Premier League,ALG,Midfilder,"10,400,000",31,367,75,442
55,Juventus,Serie A,BRA,Defender,"10,385,000",31,325,37,362
56,Juventus,Serie A,ITA,Defender,"10,380,000",35,477,116,593
57,Juventus,Serie A,POL,Goalkeeper,"10,380,000",32,373,64,437
58,Barcelona,La Liga,CIV,Midfilder,"10,346,000",25,253,56,309
59,Barcelona,La Liga,ESP,Midfilder,"10,346,000",34,480,137,617
60,Barcelona,La Liga,FRA,Midfilder,"10,346,000",25,165,27,192
61,Barcelona,La Liga,BRA,Midfilder,"10,346,000",25,190,9,199
62,Barcelona,La Liga,ESP,Forward,"10,346,000",19,44,4,48
63,Barcelona,La Liga,DEN,Defender,"10,346,000",26,160,56,216
64,Nottm Forest,Premier League,CRC,Goalkeeper,"10,317,000",35,325,107,432
65,Tottenham,Premier League,KOR,Midfilder,"10,244,000",30,379,102,481
66,A. Bilbao,La Liga,GHA,Midfilder,"9,887,000",28,309,0,309
67,Liverpool,Premier League,ENG,Midfilder,"9,880,000",32,406,69,475
68,Liverpool,Premier League,BRA,Goalkeeper,"9,880,000",29,224,55,279
69,Chelsea,Premier League,ENG,Defender,"9,880,000",25,147,17,164
70,R. Madrid,La Liga,BRA,Forward,"9,672,000",22,164,14,178
71,Barcelona,La Liga,ESP,Defender,"9,656,000",33,434,85,519
72,Inter,Serie A,ARG,Forward,"9,578,000",25,187,38,225
73,Inter,Serie A,CRO,Midfilder,"9,578,000",29,364,74,438
74,FC Bayern,Bundesliga,FRA,Defender,"9,457,000",23,180,6,186
75,Borussia Dortmund,Bundesliga,CIV,Forward,"9,457,000",28,290,15,305
76,Capitoline,Serie A,NED,Midfilder,"9,439,000",31,470,85,555
77,R. Madrid,La Liga,URU,Midfilder,"9,405,000",24,175,42,217
78,Arsenal,Premier League,BRA,Forward,"9,360,000",21,80,3,83
79,Man City,Premier League,POR,Midfilder,"9,360,000",28,313,70,383
80,Liverpool,Premier League,BRA,Defender,"9,360,000",28,319,27,346
81,Man City,Premier League,BRA,Goalkeeper,"9,360,000",29,296,18,314
82,Tottenham,Premier League,CRO,Defender,"9,360,000",33,433,113,546
83,Liverpool,Premier League,BRA,Forward,"9,360,000",30,414,55,469
84,Chelsea,Premier League,ARG,Midfilder,"9,360,000",21,71,2,73
85,Man City,Premier League,ENG,Defender,"9,100,000",32,400,68,468
86,Tottenham,Premier League,ARG,Defender,"9,100,000",24,131,11,142
87,Man City,Premier League,POR,Defender,"9,100,000",25,214,37,251
88,Tottenham,Premier League,BRA,Forward,"9,100,000",25,241,36,277
89,PSG,Ligue 1 Uber Eats,MAR,Defender,"8,924,000",23,167,51,218
90,Juventus,Serie A,FRA,Midfilder,"8,845,000",29,281,91,372
91,Chelsea,Premier League,GAB,Forward,"8,840,000",33,445,73,518
92,Man UFC,Premier League,ENG,Defender,"8,840,000",27,212,21,233
93,Man UFC,Premier League,DEN,Midfilder,"8,840,000",30,399,115,514
94,Man UFC,Premier League,SWE,Defender,"8,840,000",28,334,52,386
95,Borussia Dortmund,Bundesliga,GER,Defender,"8,621,000",27,234,40,274
96,RB Leipzig,Bundesliga,GER,Midfilder,"8,598,000",26,283,53,336
97,Borussia Dortmund,Bundesliga,BEL,Defender,"8,598,000",30,324,56,380
98,Borussia Dortmund,Bundesliga,GER,Defender,"8,598,000",33,435,76,511
99,PSG,Ligue 1 Uber Eats,FRA,Defender,"8,598,000",27,159,28,187
100,Borussia Dortmund,Bundesliga,GER,Forward,"8,598,000",33,390,48,438
101,Man City,Premier League,GER,Midfilder,"8,580,000",31,320,59,379
102,Liverpool,Premier League,SCO,Defender,"8,320,000",28,337,59,396
103,Man City,Premier League,ESP,Defender,"8,320,000",26,246,33,279
104,Arsenal,Premier League,GHA,Midfilder,"8,320,000",29,281,40,321
105,Man City,Premier League,ENG,Midfilder,"8,320,000",26,221,23,244
106,Newcastle,Premier League,BRA,Midfilder,"8,320,000",24,135,8,143
107,Leicester,Premier League,ENG,Forward,"8,320,000",35,518,26,544
108,Liverpool,Premier League,ENG,Defender,"8,320,000",23,168,17,185
109,A. Madrid,La Liga,NED,Forward,"8,290,000",28,291,79,370
110,Barcelona,La Liga,FRA,Defender,"8,190,000",23,155,11,166
111,A. Madrid,La Liga,ESP,Forward,"8,151,000",29,388,56,444
112,Chelsea,Premier League,POR,Forward,"8,082,000",22,142,22,164
113,R. Madrid,La Liga,ESP,Defender,"7,984,000",30,320,29,349
114,R. Madrid,La Liga,FRA,Defender,"7,984,000",27,179,7,186
115,R. Madrid,La Liga,BRA,Defender,"7,984,000",24,132,22,154
116,Juventus,Serie A,COL,Defender,"7,983,000",34,369,113,482
117,Inter,Serie A,TUR,Midfilder,"7,983,000",28,334,72,406
118,Juventus,Serie A,BRA,Defender,"7,983,000",25,125,0,125
119,Juventus,Serie A,ITA,Midfilder,"7,983,000",24,178,37,215
120,Inter,Serie A,BIH,Forward,"7,983,000",36,576,124,700
121,Inter,Serie A,ITA,Midfilder,"7,983,000",25,224,39,263
122,Chelsea,Premier League,ESP,Defender,"7,800,000",33,499,40,539
123,Chelsea,Premier League,GER,Forward,"7,800,000",23,180,28,208
124,Chelsea,Premier League,ENG,Midfilder,"7,800,000",26,132,10,142
125,Chelsea,Premier League,CRO,Midfilder,"7,800,000",28,317,81,398
126,Chelsea,Premier League,UKR,Midfilder,"7,800,000",21,49,5,54
127,Chelsea,Premier League,USA,Midfilder,"7,800,000",23,169,51,220
128,Man UFC,Premier League,BRA,Midfilder,"7,800,000",22,91,9,100
129,Barcelona,La Liga,ESP,Midfilder,"7,738,000",19,90,12,102
130,Juventus,Serie A,ARG,Midfilder,"7,738,000",28,215,44,259
131,Juventus,Serie A,FRA,Midfilder,"7,733,000",27,260,29,289
132,Chelsea,Premier League,ESP,Goalkeeper,"7,621,000",27,272,11,283
133,Barcelona,La Liga,GER,Goalkeeper,"7,397,000",30,348,28,376
134,A. Madrid,La Liga,BEL,Defender,"7,397,000",29,294,57,351
135,A. Madrid,La Liga,ESP,Defender,"7,397,000",27,230,5,235
136,Man UFC,Premier League,AUT,Midfilder,"7,308,000",28,373,64,437
137,Borussia Dortmund,Bundesliga,GER,Defender,"7,308,000",28,285,37,322
138,Liverpool,Premier League,URU,Forward,"7,280,000",23,109,11,120
139,Liverpool,Premier League,POR,Forward,"7,280,000",25,237,27,264
140,Liverpool,Premier League,CMR,Defender,"7,280,000",31,328,27,355
141,Man UFC,Premier League,NED,Midfilder,"7,280,000",25,187,19,206
142,PSG,Ligue 1 Uber Eats,ESP,Defender,"7,222,000",29,212,11,223
143,Capitoline,Serie A,ARG,Forward,"7,182,000",28,343,34,377
144,A. Bilbao,La Liga,ESP,Midfilder,"7,173,000",36,579,2,581
145,R. Madrid,La Liga,BRA,Forward,"6,909,000",21,124,5,129
146,R. Madrid,La Liga,ESP,Defender,"6,909,000",32,360,22,382
147,A. Madrid,La Liga,ESP,Defender,"6,897,000",27,212,16,228
148,Sporting CP,Primiera Liga,POR,Forward,"6,878,000",22,140,7,147
149,FC Bayern,Bundesliga,MAR,Defender,"6,878,000",24,157,12,169
150,FC Bayern,Bundesliga,CAN,Defender,"6,878,000",21,169,32,201
151,Man UFC,Premier League,BRA,Midfilder,"6,760,000",29,239,28,267
152,Everton,Premier League,SEN,Midfilder,"6,760,000",32,343,88,431
153,Liverpool,Premier League,GUI,Midfilder,"6,760,000",27,216,50,266
154,Man City,Premier League,ESP,Defender,"6,760,000",28,310,15,325
155,West Ham,Premier League,BRA,Midfilder,"6,760,000",25,155,35,190
156,Crystal Palace,Premier League,CIV,Midfilder,"6,760,000",29,411,26,437
157,R. Madrid,La Liga,ESP,Midfilder,"6,725,000",26,198,11,209
158,AS Monaco,Ligue 1 Uber Eats,FRA,Forward,"6,706,000",32,378,19,397
159,R. Madrid,La Liga,FRA,Midfilder,"6,665,000",19,102,3,105
160,Juventus,Serie A,ARG,Midfilder,"6,630,000",34,461,122,583
161,Liverpool,Premier League,BRA,Midfilder,"6,552,000",26,132,22,154
162,Aston Villa,Premier League,BRA,Midfilder,"6,500,000",30,332,63,395
163,West Ham,Premier League,ENG,Forward,"6,500,000",30,311,3,314
164,Liverpool,Premier League,ENG,Midfilder,"6,500,000",29,255,35,290
165,OGC Nice,Ligue 1 Uber Eats,WAL,Midfilder,"6,483,000",31,354,75,429
166,Barcelona,La Liga,URU,Defender,"6,466,000",23,150,11,161
167,Barcelona,La Liga,ESP,Midfilder,"6,466,000",18,41,10,51
168,RB Leipzig,Bundesliga,FRA,Midfilder,"6,448,000",24,156,6,162
169,FC Bayern,Bundesliga,CMR,Forward,"6,448,000",33,345,68,413
170,Lazio,Serie A,ITA,Forward,"6,388,000",32,384,55,439
171,Capitoline,Serie A,ITA,Midfilder,"6,379,000",26,201,23,224
172,Milan,Serie A,ALG,Midfilder,"6,335,000",24,184,40,224
173,Everton,Premier League,MLI,Midfilder,"6,240,000",29,278,2,280
174,Nottm Forest,Premier League,ENG,Goalkeeper,"6,240,000",25,149,1,150
175,Chelsea,Premier League,FRA,Defender,"6,240,000",21,106,0,106
176,Everton,Premier League,COL,Defender,"6,240,000",27,193,39,232
177,Man City,Premier League,ENG,Forward,"6,240,000",22,104,16,120
178,Man UFC,Premier League,ARG,Defender,"6,240,000",24,127,7,134
179,LOSC,Ligue 1 Uber Eats,POR,Midfilder,"6,240,000",29,233,29,262
180,Arsenal,Premier League,UKR,Defender,"6,240,000",25,132,52,184
181,Arsenal,Premier League,NOR,Midfilder,"6,240,000",23,242,43,285
182,West Ham,Premier League,FRA,Goalkeeper,"6,240,000",29,220,3,223
183,Arsenal,Premier League,BRA,Forward,"6,240,000",25,212,56,268
184,Aston Villa,Premier League,FRA,Defender,"6,240,000",29,274,46,320
185,Leicester,Premier League,BEL,Midfilder,"6,240,000",25,313,52,365
186,Leicester,Premier League,POR,Defender,"6,240,000",28,234,7,241
187,Tottenham,Premier League,FRA,Goalkeeper,"6,240,000",35,559,139,698
188,Bayer 04,Bundesliga,ENG,Defender,"6,240,000",21,78,3,81
189,Liverpool,Premier League,ENG,Defender,"6,240,000",36,601,61,662
190,Newcastle,Premier League,SWE,Forward,"6,240,000",22,165,37,202
191,Parthenope,Serie A,FRA,Midfilder,"6,240,000",25,165,7,172
192,R. Madrid,La Liga,FRA,Midfilder,"6,190,000",22,104,12,116
193,R. Madrid,La Liga,ESP,Forward,"6,141,000",26,269,29,298
194,Inter,Serie A,NED,Defender,"6,069,000",30,358,57,415
195,FC Bayern,Bundesliga,FRA,Defender,"6,018,000",26,191,45,236
196,Borussia Dortmund,Bundesliga,GER,Midfilder,"6,014,000",26,267,38,305
197,Arsenal,Premier League,BEL,Defender,"5,720,000",27,290,19,309
198,Leicester,Premier League,ENG,Midfilder,"5,720,000",25,236,1,237
199,Everton,Premier League,ENG,Goalkeeper,"5,720,000",28,334,45,379
200,Wolves,Premier League,ESP,Midfilder,"5,720,000",30,372,22,394
201,Arsenal,Premier League,ITA,Midfilder,"5,720,000",30,395,44,439
202,Arsenal,Premier League,SCO,Defender,"5,720,000",25,170,32,202
203,Liverpool,Premier League,NED,Midfilder,"5,720,000",23,131,7,138
204,Man UFC,Premier League,ENG,Defender,"5,720,000",30,204,27,231
205,Arsenal,Premier League,SUI,Midfilder,"5,720,000",29,383,104,487
206,Man City,Premier League,NED,Defender,"5,720,000",27,182,27,209
207,Tottenham,Premier League,DEN,Midfilder,"5,720,000",27,287,58,345
208,Chelsea,Premier League,ESP,Defender,"5,720,000",24,190,1,191
209,OGC Nice,Ligue 1 Uber Eats,ENG,Midfilder,"5,604,000",28,249,33,282
210,Sevilla,La Liga,CRO,Midfilder,"5,604,000",34,545,106,651
211,A. Madrid,La Liga,CTA,Midfilder,"5,588,000",29,307,13,320
212,Milan,Serie A,ESP,Forward,"5,588,000",23,81,1,82
213,Parthenope,Serie A,POL,Midfilder,"5,587,000",28,300,72,372
214,Juventus,Serie A,ITA,Defender,"5,587,000",28,186,7,193
215,Inter,Serie A,ARG,Forward,"5,587,000",28,250,17,267
216,A. Madrid,La Liga,FRA,Defender,"5,582,000",26,229,27,256
217,Real Hispalis,La Liga,FRA,Forward,"5,527,000",29,248,25,273
218,R. Madrid,La Liga,DOM,Forward,"5,527,000",29,179,1,180
219,R. Madrid,La Liga,ESP,Defender,"5,527,000",26,198,4,202
220,R. Madrid,La Liga,ESP,Defender,"5,527,000",31,340,9,349
221,OGC Nice,Ligue 1 Uber Eats,CIV,Forward,"5,460,000",27,240,32,272
222,A. Madrid,La Liga,BEL,Defender,"5,380,000",33,446,124,570
223,Bournemouth,Premier League,BRA,Goalkeeper,"5,200,000",33,205,1,206
224,Chelsea,Premier League,ENG,Midfilder,"5,200,000",20,58,0,58
225,Leicester,Premier League,NIR,Defender,"5,200,000",34,378,98,476
226,Southampton,Premier League,ENG,Midfilder,"5,200,000",27,312,11,323
227,Tottenham,Premier League,ENG,Defender,"5,200,000",28,286,45,331
228,Newcastle,Premier League,ENG,Goalkeeper,"5,200,000",30,257,8,265
229,Leicester,Premier League,ENG,Defender,"5,200,000",24,141,1,142
230,Man UFC,Premier League,ENG,Defender,"5,200,000",24,132,0,132
231,Leicester,Premier League,ENG,Midfilder,"5,200,000",24,189,1,190
232,OL,Ligue 1 Uber Eats,FRA,Defender,"5,200,000",19,32,0,32
233,Newcastle,Premier League,ENG,Defender,"5,200,000",31,361,37,398
234,Wolves,Premier League,MEX,Forward,"5,200,000",31,370,96,466
235,Tottenham,Premier League,MLI,Midfilder,"5,200,000",26,164,26,190
236,Everton,Premier League,NGA,Midfilder,"5,200,000",26,190,58,248
237,Arsenal,Premier League,BRA,Defender,"5,200,000",24,134,0,134
238,Wolves,Premier League,POR,Midfilder,"5,200,000",35,555,146,701
239,Wolves,Premier League,POR,Midfilder,"5,200,000",24,100,8,108
240,Nottm Forest,Premier League,ENG,Midfilder,"5,200,000",29,219,32,251
241,Tottenham,Premier League,WAL,Defender,"5,200,000",29,254,74,328
242,Aston Villa,Premier League,ARG,Goalkeeper,"5,200,000",30,152,17,169
243,Aston Villa,Premier League,BRA,Defender,"5,200,000",29,252,0,252
244,West Ham,Premier League,FRA,Defender,"5,200,000",27,265,11,276
245,Chelsea,Premier League,MAR,Midfilder,"5,200,000",29,265,40,305
246,Sevilla,La Liga,BRA,Defender,"5,200,000",29,271,6,277
247,Tottenham,Premier League,URU,Midfilder,"5,200,000",25,207,49,256
248,Villarreal,La Liga,ARG,Midfilder,"5,200,000",26,183,39,222
249,OM,Ligue 1 Uber Eats,CIV,Defender,"5,200,000",28,137,46,183
250,Chelsea,Premier League,ENG,Midfilder,"5,200,000",18,14,0,14
251,Leeds,Premier League,ESP,Forward,"5,200,000",31,342,27,369
252,Barcelona,La Liga,ESP,Defender,"5,200,000",31,303,9,312
253,Aston Villa,Premier League,FRA,Midfilder,"5,200,000",22,137,3,140
254,A. Bilbao,La Liga,ESP,Midfilder,"5,173,000",33,388,2,390
255,Borussia Dortmund,Bundesliga,GER,Forward,"5,159,000",20,108,4,112
256,Sampdoria,Serie A,VEN,Midfilder,"5,159,000",34,410,118,528
257,Chelsea,Premier League,BRA,Defender,"5,155,000",37,481,109,590
258,Borussia Dortmund,Bundesliga,GER,Defender,"5,155,000",29,231,12,243
259,Lazio,Serie A,SRB,Midfilder,"5,112,000",27,272,34,306
260,Milan,Serie A,FRA,Midfilder,"5,043,000",28,217,1,218
261,A. Madrid,La Liga,ARG,Midfilder,"4,999,000",28,318,41,359
262,Parthenope,Serie A,NGA,Forward,"4,974,000",23,127,23,150
263,Capitoline,Serie A,ENG,Forward,"4,974,000",24,208,11,219
264,Parthenope,Serie A,MEX,Forward,"4,974,000",27,272,58,330
265,Tottenham,Premier League,FRA,Defender,"4,958,000",27,239,15,254
266,Liverpool,Premier League,ENG,Defender,"4,940,000",25,115,11,126
267,West Ham,Premier League,ITA,Defender,"4,940,000",28,125,27,152
268,West Ham,Premier League,GER,Defender,"4,940,000",25,155,20,175
269,Bayer 04,Bundesliga,CZE,Forward,"4,931,000",26,193,33,226
270,Lazio,Serie A,ITA,Defender,"4,793,000",27,244,12,256
271,Fiorentina,Serie A,SRB,Defender,"4,793,000",24,209,37,246
272,Capitoline,Serie A,ITA,Defender,"4,793,000",29,282,29,311
273,Sassuolo,Serie A,ITA,Forward,"4,793,000",28,313,24,337
274,Inter,Serie A,SVK,Defender,"4,793,000",27,298,54,352
275,Capitoline,Serie A,ITA,Defender,"4,793,000",29,204,20,224
276,OM,Ligue 1 Uber Eats,FRA,Midfilder,"4,785,000",29,363,5,368
277,Juventus,Serie A,ITA,Midfilder,"4,785,000",24,179,24,203
278,Capitoline,Serie A,ITA,Midfilder,"4,785,000",27,211,27,238
279,AS Monaco,Ligue 1 Uber Eats,GER,Goalkeeper,"4,742,000",25,141,0,141
280,FC Bayern,Bundesliga,GER,Midfilder,"4,729,000",19,74,15,89
281,OL,Ligue 1 Uber Eats,FRA,Forward,"4,680,000",31,367,16,383
282,Newcastle,Premier League,ENG,Forward,"4,680,000",30,284,4,288
283,Newcastle,Premier League,NED,Defender,"4,680,000",22,122,0,122
284,Benfica,Primiera Liga,POR,Midfilder,"4,680,000",25,236,32,268
285,Liverpool,Premier League,COL,Forward,"4,680,000",25,197,37,234
286,Sampdoria,Serie A,ENG,Midfilder,"4,680,000",26,130,10,140
287,Leicester,Premier League,NGA,Forward,"4,680,000",25,174,43,217
288,Arsenal,Premier League,ENG,Defender,"4,680,000",24,177,4,181
289,Everton,Premier League,ENG,Defender,"4,680,000",29,347,2,349
290,Newcastle,Premier League,FRA,Midfilder,"4,680,000",25,212,0,212
291,Man City,Premier League,SUI,Defender,"4,680,000",27,200,41,241
292,Tottenham,Premier League,BRA,Midfilder,"4,680,000",30,365,36,401
293,Newcastle,Premier League,ENG,Forward,"4,680,000",21,76,0,76
294,Fulham,Premier League,FRA,Defender,"4,643,000",30,182,13,195
295,RB Leipzig,Bundesliga,SEN,Defender,"4,643,000",26,154,17,171
296,Salento,Serie A,FRA,Defender,"4,595,000",28,227,31,258
297,PSG,Ligue 1 Uber Eats,ESP,Defender,"4,594,000",25,222,9,231
298,Sevilla,La Liga,SRB,Defender,"4,559,000",30,327,48,375
299,Real San Sebastian,La Liga,ESP,Midfilder,"4,483,000",36,562,125,687
300,Inter,Serie A,ITA,Defender,"4,474,000",23,124,15,139
301,Juventus,Serie A,BRA,Defender,"4,423,000",31,312,45,357
302,Milan,Serie A,BEL,Forward,"4,423,000",27,209,32,241
303,Milan,Serie A,FRA,Defender,"4,423,000",24,180,7,187
304,Fulham,Premier League,GER,Goalkeeper,"4,420,000",30,398,9,407
305,Crystal Palace,Premier League,FRA,Forward,"4,420,000",24,162,0,162
306,Aston Villa,Premier League,JAM,Midfilder,"4,420,000",25,200,17,217
307,Wolves,Premier League,POR,Defender,"4,420,000",28,309,24,333
308,Everton,Premier League,ENG,Forward,"4,368,000",25,200,11,211
309,A. Bilbao,La Liga,ESP,Defender,"4,311,000",31,400,19,419
310,Salernitana,Serie A,POL,Forward,"4,311,000",27,300,23,323
311,Bayer 04,Bundesliga,GER,Midfilder,"4,311,000",29,246,2,248
312,A. Madrid,La Liga,ARG,Midfilder,"4,311,000",27,290,20,310
313,A. Madrid,La Liga,URU,Defender,"4,311,000",27,195,78,273
314,Bayer 04,Bundesliga,CHI,Midfilder,"4,299,000",33,437,97,534
315,FC Bayern,Bundesliga,SUI,Goalkeeper,"4,299,000",33,504,74,578
316,Borussia Dortmund,Bundesliga,FRA,Forward,"4,299,000",34,403,0,403
317,OL,Ligue 1 Uber Eats,GER,Defender,"4,299,000",34,378,76,454
318,OM,Ligue 1 Uber Eats,MAR,Midfilder,"4,299,000",25,161,14,175
319,RB Leipzig,Bundesliga,GER,Defender,"4,299,000",26,193,18,211
320,OL,Ligue 1 Uber Eats,FRA,Midfilder,"4,299,000",28,193,28,221
321,Borussia Dortmund,Bundesliga,POR,Defender,"4,296,000",28,275,56,331
322,Bayer 04,Bundesliga,GER,Midfilder,"4,259,000",32,310,11,321
323,Capitoline,Serie A,ENG,Defender,"4,199,000",32,308,31,339
324,Inter,Serie A,ARM,Midfilder,"4,199,000",33,438,94,532
325,A. Madrid,La Liga,ESP,Defender,"4,160,000",25,180,6,186
326,West Ham,Premier League,ESP,Midfilder,"4,160,000",26,274,6,280
327,Nottm Forest,Premier League,ENG,Midfilder,"4,160,000",30,364,6,370
328,Leicester,Premier League,NGA,Midfilder,"4,160,000",25,235,48,283
329,Leicester,Premier League,FRA,Midfilder,"4,160,000",23,103,0,103
330,Newcastle,Premier League,ENG,Defender,"4,160,000",26,159,0,159
331,Chelsea,Premier League,ENG,Defender,"4,160,000",23,133,0,133
332,Newcastle,Premier League,ENG,Midfilder,"4,160,000",23,89,0,89
333,Nottm Forest,Premier League,NZL,Forward,"4,160,000",30,454,70,524
334,Brighton,Premier League,ENG,Defender,"4,160,000",30,349,1,350
335,Man UFC,Premier League,SCO,Defender,"4,160,000",25,126,34,160
336,Aston Villa,Premier League,ENG,Defender,"4,160,000",37,524,39,563
337,West Ham,Premier League,ENG,Midfilder,"4,160,000",25,227,4,231
338,Arsenal,Premier League,ENG,Goalkeeper,"4,160,000",24,156,3,159
339,Sevilla,La Liga,ESP,Midfilder,"4,160,000",21,92,4,96
340,Newcastle,Premier League,BRA,Midfilder,"4,160,000",26,214,0,214
341,Arsenal,Premier League,POR,Midfilder,"4,160,000",22,88,0,88
342,Crystal Palace,Premier League,SRB,Midfilder,"4,160,000",31,342,39,381
343,Man City,Premier League,ARG,Forward,"4,160,000",22,81,9,90
344,Real Hispalis,La Liga,ESP,Midfilder,"4,160,000",29,325,0,325
345,Leicester,Premier League,ENG,Defender,"4,160,000",33,408,19,427
346,Leicester,Premier League,ZAM,Forward,"4,160,000",23,138,31,169
347,Aston Villa,Premier League,ARG,Midfilder,"4,160,000",25,262,1,263
348,Hertha Berlin,Bundesliga,FRA,Midfilder,"4,138,000",25,194,0,194
349,AS Monaco,Ligue 1 Uber Eats,GER,Midfilder,"4,127,000",30,386,14,400
350,PSG,Ligue 1 Uber Eats,POR,Midfilder,"4,091,000",22,78,3,81
351,Valencia,La Liga,BRA,Defender,"4,056,000",31,315,0,315
352,AS Monaco,Ligue 1 Uber Eats,JPN,Forward,"4,035,000",27,244,42,286
353,Chelsea,Premier League,ENG,Midfilder,"4,004,000",23,175,31,206
354,Inter,Serie A,SVN,Goalkeeper,"3,992,000",38,598,81,679
355,Milan,Serie A,ITA,Midfilder,"3,992,000",22,153,11,164
356,Lazio,Serie A,ESP,Midfilder,"3,992,000",29,322,1,323
357,Tottenham,Premier League,SWE,Midfilder,"3,987,000",22,118,25,143
358,AS Monaco,Ligue 1 Uber Eats,RUS,Midfilder,"3,955,000",26,192,45,237
359,A. Bilbao,La Liga,ESP,Defender,"3,910,000",32,323,0,323
360,Aston Villa,Premier League,BEL,Defender,"3,900,000",27,244,29,273
361,Leicester,Premier League,DEN,Defender,"3,900,000",30,291,35,326
362,Newcastle,Premier League,PAR,Midfilder,"3,900,000",28,252,44,296
363,Tottenham,Premier League,COL,Defender,"3,900,000",26,185,51,236
364,Crystal Palace,Premier League,DEN,Defender,"3,900,000",26,219,17,236
365,Wolves,Premier League,ESP,Defender,"3,900,000",28,316,3,319
366,Arsenal,Premier League,ENG,Forward,"3,900,000",23,82,0,82
367,Leicester,Premier League,ENG,Midfilder,"3,900,000",23,83,0,83
368,Chelsea,Premier League,ALB,Forward,"3,900,000",20,69,14,83
369,Tottenham,Premier League,ENG,Goalkeeper,"3,900,000",34,353,6,359
370,Tottenham,Premier League,BRA,Defender,"3,900,000",23,136,7,143
371,Everton,Premier League,ENG,Midfilder,"3,900,000",22,140,0,140
372,Leeds,Premier League,ENG,Forward,"3,900,000",29,285,1,286
373,Leicester,Premier League,BEL,Midfilder,"3,900,000",28,305,15,320
374,A. Madrid,La Liga,IRL,Defender,"3,900,000",30,322,29,351
375,Sevilla,La Liga,ESP,Defender,"3,880,000",36,600,46,646
376,RB Leipzig,Bundesliga,AUT,Midfilder,"3,877,000",24,186,29,215
377,Milan,Serie A,CRO,Forward,"3,871,000",28,239,42,281
378,Milan,Serie A,FRA,Forward,"3,871,000",35,478,112,590
379,Milan,Serie A,ENG,Defender,"3,871,000",24,147,3,150
380,A. Madrid,La Liga,MNE,Defender,"3,869,000",31,321,62,383
381,Barcelona,La Liga,ESP,Defender,"3,869,000",30,312,11,323
382,Borussia M'gladbach,Bundesliga,FRA,Forward,"3,869,000",25,188,4,192
383,PSG,Ligue 1 Uber Eats,POR,Defender,"3,869,000",30,294,61,355
384,Bayer 04,Bundesliga,GER,Midfilder,"3,869,000",19,60,4,64
385,Capitoline,Serie A,ITA,Forward,"3,828,000",28,333,44,377
386,Capitoline,Serie A,SRB,Midfilder,"3,786,000",34,419,48,467
387,Everton,Premier League,ENG,Defender,"3,770,000",25,157,0,157
388,Parthenope,Serie A,ITA,Defender,"3,673,000",29,324,21,345
389,Nottm Forest,Premier League,BRA,Defender,"3,640,000",33,264,2,266
390,West Ham,Premier League,ITA,Forward,"3,640,000",23,132,7,139
391,Leeds,Premier League,COL,Midfilder,"3,640,000",23,126,7,133
392,Torino,Serie A,CRO,Forward,"3,640,000",24,208,39,247
393,Aston Villa,Premier League,ENG,Midfilder,"3,640,000",21,69,0,69
394,Crystal Palace,Premier League,ESP,Goalkeeper,"3,640,000",35,385,0,385
395,Aston Villa,Premier League,SCO,Midfilder,"3,640,000",27,331,48,379
396,Leicester,Premier League,BEL,Defender,"3,640,000",26,215,24,239
397,Southampton,Premier League,ENG,Midfilder,"3,640,000",33,401,47,448
398,West Ham,Premier League,ARG,Midfilder,"3,640,000",29,310,5,315
399,Everton,Premier League,IRL,Defender,"3,640,000",33,373,65,438
400,Liverpool,Premier League,FRA,Defender,"3,640,000",23,89,2,91
401,Crystal Palace,Premier League,ENG,Defender,"3,640,000",31,343,14,357
402,Aston Villa,Premier League,ENG,Defender,"3,640,000",24,209,0,209
403,Everton,Premier League,ENG,Defender,"3,640,000",29,306,12,318
404,West Ham,Premier League,JAM,Midfilder,"3,640,000",32,413,6,419
405,Aston Villa,Premier League,ENG,Defender,"3,640,000",29,211,17,228
406,Southampton,Premier League,CRO,Midfilder,"3,640,000",29,366,19,385
407,RB Leipzig,Bundesliga,POR,Forward,"3,586,000",26,272,51,323
408,Spezia,Serie A,ITA,Defender,"3,509,000",28,159,2,161
409,Parthenope,Serie A,ITA,Forward,"3,509,000",29,332,7,339
410,Brighton,Premier League,ENG,Midfilder,"3,484,000",34,427,34,461
411,PSG,Ligue 1 Uber Eats,POR,Midfilder,"3,476,000",25,177,32,209
412,Milan,Serie A,USA,Defender,"3,449,000",21,92,17,109
413,RB Leipzig,Bundesliga,ESP,Midfilder,"3,448,000",24,175,24,199
414,Getafe,La Liga,ESP,Midfilder,"3,448,000",24,170,0,170
415,Mallorca,La Liga,KOS,Forward,"3,448,000",28,275,42,317
416,Nottm Forest,Premier League,BRA,Defender,"3,448,000",24,119,15,134
417,VfL Wolfsburg,Bundesliga,GER,Midfilder,"3,439,000",28,293,3,296
418,VfL Wolfsburg,Bundesliga,FRA,Defender,"3,439,000",22,92,0,92
419,Hoffenheim,Bundesliga,GER,Defender,"3,439,000",32,373,28,401
420,Bayer 04,Bundesliga,FIN,Goalkeeper,"3,439,000",32,384,78,462
421,Hoffenheim,Bundesliga,DEN,Midfilder,"3,439,000",31,311,69,380
422,Sevilla,La Liga,FRA,Defender,"3,439,000",20,33,0,33
423,SV Werder,Bundesliga,GER,Forward,"3,439,000",28,227,0,227
424,Getafe,La Liga,MAR,Forward,"3,439,000",27,203,11,214
425,Borussia Dortmund,Bundesliga,TUR,Midfilder,"3,439,000",24,166,5,171
426,Borussia Dortmund,Bundesliga,NED,Forward,"3,439,000",23,135,18,153
427,Wolves,Premier League,BRA,Forward,"3,439,000",23,139,7,146
428,Borussia M'gladbach,Bundesliga,GER,Midfilder,"3,439,000",26,260,6,266
429,Borussia M'gladbach,Bundesliga,GER,Midfilder,"3,439,000",30,283,14,297
430,VfL Wolfsburg,Bundesliga,BEL,Goalkeeper,"3,439,000",30,262,4,266
431,Hoffenheim,Bundesliga,CRO,Forward,"3,439,000",31,342,71,413
432,RB Leipzig,Bundesliga,SWE,Midfilder,"3,437,000",30,362,74,436
433,Borussia Dortmund,Bundesliga,GER,Midfilder,"3,437,000",26,172,2,174
434,Brighton,Premier League,GER,Midfilder,"3,432,000",31,385,0,385
435,Juventus,Serie A,POL,Forward,"3,404,000",28,262,62,324
436,Liverpool,Premier League,GRE,Defender,"3,380,000",26,128,22,150
437,Leeds,Premier League,ESP,Midfilder,"3,380,000",25,177,0,177
438,Liverpool,Premier League,ENG,Midfilder,"3,380,000",21,45,0,45
439,Aston Villa,Premier League,ESP,Defender,"3,380,000",29,322,0,322
440,Southampton,Premier League,ENG,Defender,"3,380,000",25,132,5,137
441,Fulham,Premier League,SRB,Forward,"3,380,000",27,357,74,431
442,Wolves,Premier League,ENG,Defender,"3,380,000",32,464,0,464
443,Aston Villa,Premier League,POL,Defender,"3,380,000",25,214,7,221
444,Fulham,Premier League,POR,Defender,"3,380,000",31,257,34,291
445,West Ham,Premier League,CIV,Defender,"3,380,000",25,241,28,269
446,Everton,Premier League,ENG,Defender,"3,380,000",24,172,2,174
447,Nottm Forest,Premier League,SEN,Defender,"3,380,000",26,235,0,235
448,Newcastle,Premier League,SCO,Midfilder,"3,380,000",28,273,22,295
449,Man UFC,Premier League,ENG,Goalkeeper,"3,380,000",36,347,3,350
450,Arsenal,Premier League,JPN,Defender,"3,380,000",23,170,28,198
451,West Ham,Premier League,MAR,Defender,"3,380,000",26,168,25,193
452,Fulham,Premier League,FRA,Defender,"3,380,000",25,187,0,187
453,West Ham,Premier League,ITA,Defender,"3,380,000",34,388,13,401
454,Aston Villa,Premier League,BRA,Midfilder,"3,380,000",24,173,9,182
455,Capitoline,Serie A,NED,Defender,"3,370,000",27,178,3,181
456,OGC Nice,Ligue 1 Uber Eats,DEN,Goalkeeper,"3,362,000",35,579,84,663
457,Parthenope,Serie A,POR,Defender,"3,354,000",31,314,11,325
458,OM,Ligue 1 Uber Eats,ESP,Goalkeeper,"3,353,000",27,223,2,225
459,Parthenope,Serie A,KOR,Defender,"3,319,000",25,149,42,191
460,Inter,Serie A,CMR,Goalkeeper,"3,319,000",26,191,30,221
461,Bologna,Serie A,AUT,Forward,"3,319,000",33,393,102,495
462,Parthenope,Serie A,GER,Midfilder,"3,319,000",30,334,1,335
463,VfL Wolfsburg,Bundesliga,GER,Forward,"3,267,000",26,158,7,165
464,OL,Ligue 1 Uber Eats,POR,Goalkeeper,"3,267,000",31,319,14,333
465,RB Leipzig,Bundesliga,GER,Defender,"3,224,000",24,147,9,156
466,OL,Ligue 1 Uber Eats,FRA,Midfilder,"3,198,000",24,168,1,169
467,Sampdoria,Serie A,ITA,Defender,"3,190,000",28,146,1,147
468,Lazio,Serie A,ALB,Defender,"3,190,000",28,307,71,378
469,Sassuolo,Serie A,ITA,Forward,"3,190,000",23,111,0,111
470,Lazio,Serie A,ITA,Forward,"3,190,000",27,218,0,218
471,Inter,Serie A,ITA,Defender,"3,190,000",33,384,6,390
472,Capitoline,Serie A,ITA,Defender,"3,190,000",26,168,9,177
473,Sevilla,La Liga,ARG,Midfilder,"3,190,000",34,509,14,523
474,Brianza,Serie A,ITA,Midfilder,"3,190,000",27,197,9,206
475,Atalanta,Serie A,TUR,Defender,"3,190,000",24,124,35,159
476,Milan,Serie A,ITA,Defender,"3,190,000",31,318,49,367
477,Milan,Serie A,ITA,Defender,"3,190,000",25,153,7,160
478,Barcelona,La Liga,ESP,Forward,"3,138,000",22,134,28,162
479,Villarreal,La Liga,FRA,Midfilder,"3,138,000",31,260,0,260
480,Nottm Forest,Premier League,GHA,Forward,"3,120,000",32,442,107,549
481,Nottm Forest,Premier League,BRA,Forward,"3,120,000",28,248,1,249
482,Leeds,Premier League,USA,Defender,"3,120,000",23,167,30,197
483,Fulham,Premier League,POR,Midfilder,"3,120,000",27,191,14,205
484,Leeds,Premier League,ENG,Midfilder,"3,120,000",25,215,0,215
485,Crystal Palace,Premier League,GHA,Midfilder,"3,120,000",29,285,19,304
486,Strasbourg,Ligue 1 Uber Eats,FRA,Midfilder,"3,120,000",28,272,0,272
487,Leicester,Premier League,AUS,Defender,"3,120,000",23,121,5,126
488,West Ham,Premier League,POL,Goalkeeper,"3,120,000",37,394,57,451
489,West Ham,Premier League,ENG,Defender,"3,120,000",23,175,32,207
490,Southampton,Premier League,NGA,Midfilder,"3,120,000",26,203,20,223
491,Liverpool,Premier League,ESP,Goalkeeper,"3,120,000",35,233,0,233
492,Wolves,Premier League,ESP,Forward,"3,120,000",33,394,24,418
493,Southampton,Premier League,SCO,Midfilder,"3,120,000",30,348,36,384
494,Brighton,Premier League,ARG,Midfilder,"3,120,000",23,148,5,153
495,Aston Villa,Premier League,BFA,Midfilder,"3,120,000",26,227,64,291
496,Brighton,Premier League,ECU,Defender,"3,120,000",24,202,31,233
497,Wolves,Premier League,POR,Midfilder,"3,120,000",25,250,30,280
498,Everton,Premier League,ENG,Defender,"3,120,000",29,365,10,375
499,Southampton,Premier League,POL,Defender,"3,120,000",26,208,42,250
500,Leeds,Premier League,FRA,Forward,"3,120,000",20,67,0,67
501,Fulham,Premier League,SRB,Midfilder,"3,120,000",26,217,30,247
502,West Ham,Premier League,ALG,Forward,"3,120,000",27,228,17,245
503,Leicester,Premier League,BEL,Defender,"3,120,000",24,162,1,163
504,Tottenham,Premier League,ENG,Defender,"3,120,000",22,154,0,154
505,Southampton,Premier League,NOR,Midfilder,"3,120,000",28,301,45,346
506,Benfica,Primiera Liga,GER,Midfilder,"3,095,000",28,292,58,350
507,AS Monaco,Ligue 1 Uber Eats,POR,Midfilder,"3,095,000",27,237,21,258
508,Milan,Serie A,FRA,Goalkeeper,"3,095,000",27,185,4,189
509,RB Leipzig,Bundesliga,CRO,Defender,"3,071,000",20,76,10,86
510,Lazio,Serie A,URU,Midfilder,"3,035,000",31,269,60,329
511,Hoffenheim,Bundesliga,ISR,Forward,"3,017,000",30,309,40,349
512,Milan,Serie A,FRA,Defender,"3,017,000",22,45,0,45
513,Valencia,La Liga,ESP,Defender,"3,016,000",27,304,17,321
514,Arsenal,Premier League,POL,Defender,"3,016,000",22,91,2,93
515,Bayer 04,Bundesliga,GER,Defender,"3,009,000",26,245,16,261
516,VfL Wolfsburg,Bundesliga,GER,Forward,"3,009,000",23,128,6,134
517,RB Leipzig,Bundesliga,HUN,Defender,"3,009,000",29,290,33,323
518,Borussia M'gladbach,Bundesliga,FRA,Forward,"3,009,000",29,263,1,264
519,Borussia M'gladbach,Bundesliga,GER,Forward,"3,009,000",34,434,11,445
520,VfL Wolfsburg,Bundesliga,GER,Defender,"3,009,000",28,233,1,234
521,AS Monaco,Ligue 1 Uber Eats,SUI,Midfilder,"3,009,000",25,212,56,268
522,Borussia Dortmund,Bundesliga,GER,Defender,"3,007,000",27,198,0,198
523,Girona,La Liga,ESP,Defender,"3,007,000",32,429,0,429
524,RB Leipzig,Bundesliga,HUN,Goalkeeper,"3,007,000",32,335,49,384
525,RB Leipzig,Bundesliga,MLI,Midfilder,"2,994,000",24,157,32,189
526,OL,Ligue 1 Uber Eats,BRA,Defender,"2,923,000",30,288,0,288
527,RB Leipzig,Bundesliga,DEN,Midfilder,"2,911,000",28,296,68,364
528,Inter,Serie A,ITA,Defender,"2,871,000",34,411,25,436
529,Valencia,La Liga,NED,Midfilder,"2,871,000",23,162,2,164
530,Brianza,Serie A,ITA,Forward,"2,871,000",27,249,1,250
531,Atalanta,Serie A,COL,Forward,"2,871,000",31,353,34,387
532,Wolves,Premier League,KOR,Midfilder,"2,860,000",26,193,47,240
533,Brighton,Premier League,ENG,Defender,"2,860,000",27,275,0,275
534,Wolves,Premier League,BRA,Midfilder,"2,860,000",21,59,0,59
535,Fulham,Premier League,BRA,Forward,"2,860,000",27,134,0,134
536,West Ham,Premier League,CZE,Defender,"2,860,000",30,275,30,305
537,Arsenal,Premier League,ENG,Forward,"2,860,000",22,77,3,80
538,Crystal Palace,Premier League,SCO,Midfilder,"2,860,000",34,533,32,565
539,Leeds,Premier League,NIR,Defender,"2,860,000",31,407,62,469
540,Newcastle,Premier League,ENG,Defender,"2,860,000",28,261,0,261
541,Chelsea,Premier League,CIV,Forward,"2,860,000",19,44,0,44
542,Leicester,Premier League,GHA,Defender,"2,860,000",27,169,44,213
543,Fulham,Premier League,IRL,Defender,"2,860,000",30,286,55,341
544,Leeds,Premier League,ESP,Defender,"2,860,000",26,160,0,160
545,Capitoline,Serie A,POR,Goalkeeper,"2,852,000",34,481,104,585
546,Bayer 04,Bundesliga,IRN,Forward,"2,837,000",27,221,63,284
547,Eintracht Frankfurt,Bundesliga,GER,Goalkeeper,"2,802,000",32,355,6,361
548,Eintracht Frankfurt,Bundesliga,GER,Midfilder,"2,802,000",30,285,63,348
549,Capitoline,Serie A,ALB,Defender,"2,800,000",22,64,15,79
550,OM,Ligue 1 Uber Eats,FRA,Forward,"2,786,000",35,544,38,582
551,Fiorentina,Serie A,ARG,Midfilder,"2,767,000",24,155,21,176
552,Lazio,Serie A,ESP,Forward,"2,767,000",35,483,65,548
553,Leeds,Premier League,USA,Midfilder,"2,767,000",24,137,35,172
554,Juventus,Serie A,SRB,Defender,"2,767,000",29,344,48,392
555,Inter,Serie A,NED,Defender,"2,767,000",26,224,34,258
556,Vallecano,La Liga,ESP,Forward,"2,761,000",27,295,4,299
557,OL,Ligue 1 Uber Eats,FRA,Forward,"2,751,000",26,228,0,228
558,VfL Wolfsburg,Bundesliga,FRA,Defender,"2,751,000",31,309,7,316
559,1. FC Koln,Bundesliga,GER,Goalkeeper,"2,749,000",29,334,0,334
560,Bayer 04,Bundesliga,ARG,Midfilder,"2,735,000",23,87,20,107
561,OM,Ligue 1 Uber Eats,TUR,Midfilder,"2,732,000",25,203,42,245
562,Nottm Forest,Premier League,CIV,Defender,"2,718,000",29,273,79,352
563,Verona,Serie A,ITA,Forward,"2,711,000",30,292,4,296
564,Brianza,Serie A,ITA,Defender,"2,711,000",30,277,3,280
565,Rennes,Ligue 1 Uber Eats,FRA,Forward,"2,690,000",25,168,0,168
566,Sevilla,La Liga,ARG,Forward,"2,690,000",30,298,25,323
567,Rennes,Ligue 1 Uber Eats,FRA,Goalkeeper,"2,682,000",37,551,34,585
568,Vigo,La Liga,ESP,Midfilder,"2,621,000",24,128,0,128
569,Spezia,Serie A,UKR,Midfilder,"2,621,000",26,159,33,192
570,Real Hispalis,La Liga,BRA,Forward,"2,600,000",30,357,0,357
571,Fulham,Premier League,WAL,Midfilder,"2,600,000",24,117,36,153
572,Man UFC,Premier League,ENG,Defender,"2,600,000",22,47,0,47
573,Nottm Forest,Premier League,ENG,Defender,"2,600,000",24,104,0,104
574,Brentford,Premier League,ENG,Defender,"2,600,000",32,372,0,372
575,Fulham,Premier League,BRA,Midfilder,"2,600,000",26,167,1,168
576,Southampton,Premier League,ENG,Defender,"2,600,000",25,91,2,93
577,Brianza,Serie A,ESP,Defender,"2,600,000",29,264,0,264
578,Nottm Forest,Premier League,CIV,Defender,"2,600,000",31,268,13,281
579,Man UFC,Premier League,NED,Defender,"2,600,000",23,104,5,109
580,Nottm Forest,Premier League,ENG,Midfilder,"2,600,000",22,111,0,111
581,Brighton,Premier League,ENG,Forward,"2,600,000",31,288,42,330
582,Crystal Palace,Premier League,ENG,Defender,"2,600,000",33,330,0,330
583,Fulham,Premier League,ENG,Defender,"2,600,000",24,143,0,143
584,Southampton,Premier League,SCO,Forward,"2,600,000",26,342,19,361
585,Wolves,Premier League,GAB,Midfilder,"2,600,000",29,220,25,245
586,West Ham,Premier League,CZE,Midfilder,"2,600,000",27,234,52,286
587,Southampton,Premier League,NGA,Forward,"2,600,000",28,261,15,276
588,Arsenal,Premier League,ENG,Forward,"2,600,000",21,103,18,121
589,Crystal Palace,Premier League,FRA,Forward,"2,600,000",25,167,0,167
590,Crystal Palace,Premier League,BEL,Midfilder,"2,600,000",22,95,1,96
591,Newcastle,Premier League,NIR,Defender,"2,600,000",24,124,26,150
592,West Ham,Premier League,ENG,Defender,"2,600,000",32,465,3,468
593,Juventus,Serie A,ITA,Forward,"2,600,000",22,126,12,138
594,Chelsea,Premier League,SEN,Goalkeeper,"2,600,000",30,209,25,234
595,Wolves,Premier League,POR,Forward,"2,600,000",26,226,1,227
596,Southampton,Premier League,MLI,Midfilder,"2,600,000",24,113,29,142
597,Crystal Palace,Premier League,ENG,Midfilder,"2,600,000",27,295,0,295
598,Southampton,Premier League,ENG,Goalkeeper,"2,600,000",32,269,1,270
599,Everton,Premier League,FRA,Forward,"2,600,000",26,276,0,276
600,Aston Villa,Premier League,ENG,Defender,"2,600,000",27,166,3,169
601,Newcastle,Premier League,ENG,Defender,"2,600,000",30,325,0,325
602,Brighton,Premier League,NED,Defender,"2,600,000",30,252,28,280
603,Leicester,Premier League,SEN,Midfilder,"2,600,000",30,283,17,300
604,Chelsea,Premier League,BRA,Midfilder,"2,600,000",18,34,0,34
605,Southampton,Premier League,GHA,Midfilder,"2,600,000",20,76,11,87
606,Tottenham,Premier League,ENG,Midfilder,"2,600,000",21,84,0,84
607,Southampton,Premier League,BRA,Defender,"2,600,000",25,97,0,97
608,Southampton,Premier League,CRO,Defender,"2,600,000",25,238,23,261
609,Udinese,Serie A,ITA,Defender,"2,600,000",19,44,0,44
610,Brentford,Premier League,DEN,Midfilder,"2,600,000",22,136,16,152
611,Everton,Premier League,UKR,Defender,"2,600,000",23,108,27,135
612,Southampton,Premier League,ARG,Midfilder,"2,600,000",19,64,0,64
613,Arsenal,Premier League,EGY,Midfilder,"2,600,000",30,236,92,328
614,Southampton,Premier League,ENG,Forward,"2,600,000",25,292,0,292
615,Leicester,Premier League,DEN,Defender,"2,600,000",19,51,0,51
616,Crystal Palace,Premier League,USA,Defender,"2,600,000",22,77,8,85
617,Chelsea,Premier League,SUI,Midfilder,"2,592,000",25,196,40,236
618,Barcelona,La Liga,ESP,Defender,"2,586,000",21,46,17,63
619,Hoffenheim,Bundesliga,GER,Goalkeeper,"2,586,000",32,420,0,420
620,Real San Sebastian,La Liga,NOR,Forward,"2,586,000",26,226,42,268
621,Bayer 04,Bundesliga,GER,Midfilder,"2,586,000",25,213,5,218
622,Getafe,La Liga,FRA,Defender,"2,579,000",28,205,0,205
623,PSG,Ligue 1 Uber Eats,FRA,Defender,"2,579,000",24,184,1,185
624,VfL Wolfsburg,Bundesliga,SWE,Midfilder,"2,579,000",23,160,21,181
625,Borussia M'gladbach,Bundesliga,SUI,Defender,"2,579,000",25,253,38,291
626,VfL Wolfsburg,Bundesliga,BEL,Defender,"2,579,000",23,104,2,106
627,Bayer 04,Bundesliga,BFA,Defender,"2,579,000",23,118,29,147
628,FC Porto,Primiera Liga,POR,Defender,"2,579,000",39,495,128,623
629,OL,Ligue 1 Uber Eats,FRA,Midfilder,"2,579,000",22,74,0,74
630,Hoffenheim,Bundesliga,ESP,Defender,"2,579,000",25,179,0,179
631,Bayer 04,Bundesliga,FRA,Midfilder,"2,579,000",23,125,8,133
632,Hertha Berlin,Bundesliga,BEL,Midfilder,"2,579,000",24,160,4,164
633,Borussia M'gladbach,Bundesliga,GER,Midfilder,"2,579,000",25,174,10,184
634,Borussia M'gladbach,Bundesliga,ALG,Defender,"2,579,000",27,196,48,244
635,RB Leipzig,Bundesliga,FRA,Defender,"2,579,000",22,73,0,73
636,Sevilla,La Liga,MAR,Forward,"2,578,000",25,178,48,226
637,1. FC Koln,Bundesliga,GER,Defender,"2,578,000",32,414,43,457
638,RB Leipzig,Bundesliga,GER,Defender,"2,578,000",30,299,9,308
639,RB Leipzig,Bundesliga,AUT,Defender,"2,578,000",25,192,24,216
640,Hoffenheim,Bundesliga,DEN,Forward,"2,578,000",24,160,35,195
641,Borussia Dortmund,Bundesliga,ENG,Midfilder,"2,555,000",19,108,15,123
642,Fiorentina,Serie A,ITA,Midfilder,"2,552,000",25,183,1,184
643,Torino,Serie A,PAR,Forward,"2,552,000",26,196,29,225
644,Inter,Serie A,ITA,Defender,"2,552,000",24,141,4,145
645,Atalanta,Serie A,ARG,Goalkeeper,"2,552,000",28,162,2,164
646,Villarreal,La Liga,ESP,Defender,"2,550,000",25,205,19,224
647,OM,Ligue 1 Uber Eats,FRA,Midfilder,"2,494,000",27,206,0,206
648,Bayer 04,Bundesliga,ECU,Defender,"2,472,000",20,47,24,71
649,Real Hispalis,La Liga,ESP,Defender,"2,466,000",31,252,0,252
650,Tottenham,Premier League,NED,Midfilder,"2,466,000",25,134,6,140
651,Real San Sebastian,La Liga,ESP,Midfilder,"2,466,000",32,354,3,357
652,Borussia Dortmund,Bundesliga,GER,Defender,"2,466,000",22,94,4,98
653,Valladolid,La Liga,ESP,Midfilder,"2,466,000",33,408,0,408
654,Lazio,Serie A,BRA,Forward,"2,431,000",29,308,2,310
655,Milan,Serie A,BEL,Forward,"2,431,000",21,94,8,102
656,Capitoline,Serie A,ESP,Defender,"2,418,000",29,273,10,283
657,Juventus,Serie A,ITA,Goalkeeper,"2,397,000",29,269,2,271
658,Juventus,Serie A,ITA,Defender,"2,397,000",29,206,39,245
659,Inter,Serie A,ITA,Midfilder,"2,397,000",28,201,7,208
660,Torino,Serie A,SUI,Defender,"2,397,000",30,336,98,434
661,Atalanta,Serie A,CIV,Forward,"2,397,000",25,202,10,212
662,Lazio,Serie A,ITA,Defender,"2,397,000",28,383,2,385
663,Fiorentina,Serie A,ITA,Midfilder,"2,397,000",33,376,14,390
664,Parthenope,Serie A,ITA,Goalkeeper,"2,397,000",25,112,2,114
665,PSG,Ligue 1 Uber Eats,ESP,Midfilder,"2,392,000",26,206,15,221
666,Torino,Serie A,RUS,Midfilder,"2,392,000",26,218,41,259
667,Empoli,Serie A,CRO,Forward,"2,392,000",27,218,24,242
668,Parthenope,Serie A,ARG,Forward,"2,392,000",27,277,5,282
669,Villarreal,La Liga,ESP,Midfilder,"2,381,000",33,478,4,482
670,OM,Ligue 1 Uber Eats,COD,Defender,"2,376,000",28,212,66,278
671,Borussia M'gladbach,Bundesliga,GER,Midfilder,"2,364,000",31,321,12,333
672,Hoffenheim,Bundesliga,TUR,Defender,"2,364,000",22,93,17,110
673,Brentford,Premier League,ENG,Forward,"2,340,000",26,305,0,305
674,Leeds,Premier League,DEN,Defender,"2,340,000",25,162,8,170
675,Aston Villa,Premier League,ENG,Forward,"2,340,000",26,298,7,305
676,Newcastle,Premier League,SCO,Defender,"2,340,000",32,469,16,485
677,Brighton,Premier League,ENG,Defender,"2,340,000",28,224,0,224
678,Bournemouth,Premier League,COL,Midfilder,"2,340,000",27,319,33,352
679,Newcastle,Premier League,SUI,Defender,"2,340,000",30,276,71,347
680,Newcastle,Premier League,SVK,Goalkeeper,"2,340,000",33,331,29,360
681,Man City,Premier League,ARG,Midfilder,"2,340,000",19,22,0,22
682,Rennes,Ligue 1 Uber Eats,ENG,Defender,"2,340,000",22,107,0,107
683,Nottm Forest,Premier League,SUI,Midfilder,"2,340,000",30,375,46,421
684,Bournemouth,Premier League,ENG,Defender,"2,340,000",28,193,0,193
685,Brighton,Premier League,GHA,Defender,"2,340,000",21,56,0,56
686,Crystal Palace,Premier League,MLI,Midfilder,"2,340,000",22,122,8,130
687,Brentford,Premier League,DEN,Midfilder,"2,340,000",26,191,19,210
688,Crystal Palace,Premier League,ENG,Defender,"2,340,000",22,92,3,95
689,Girona,La Liga,ESP,Midfilder,"2,340,000",30,326,0,326
690,Nottm Forest,Premier League,BEL,Midfilder,"2,340,000",24,131,2,133
691,Bournemouth,Premier League,GHA,Forward,"2,340,000",22,124,1,125
692,Crystal Palace,Premier League,FRA,Forward,"2,340,000",20,100,0,100
693,Brentford,Premier League,CMR,Midfilder,"2,340,000",23,169,0,169
694,Liverpool,Premier League,ENG,Midfilder,"2,340,000",19,57,0,57
695,Bournemouth,Premier League,UKR,Defender,"2,340,000",20,50,22,72
696,Bournemouth,Premier League,ARG,Defender,"2,340,000",25,127,1,128
697,Wolves,Premier League,AUT,Forward,"2,340,000",25,141,15,156
698,Fulham,Premier League,BRA,Midfilder,"2,340,000",34,457,70,527
699,Nottm Forest,Premier League,ENG,Midfilder,"2,340,000",23,170,0,170
700,Crystal Palace,Premier League,ENG,Midfilder,"2,340,000",24,178,0,178
701,Brentford,Premier League,NOR,Defender,"2,340,000",24,217,26,243
702,Crystal Palace,Premier League,NED,Defender,"2,340,000",25,152,3,155
703,Leeds,Premier League,AUT,Defender,"2,340,000",24,163,9,172
704,Crystal Palace,Premier League,ENG,Goalkeeper,"2,340,000",29,311,3,314
705,Nottm Forest,Premier League,NGA,Forward,"2,340,000",25,163,4,167
706,Leicester,Premier League,TUR,Defender,"2,340,000",26,176,48,224
707,Bournemouth,Premier League,ENG,Forward,"2,340,000",24,181,1,182
708,Bournemouth,Premier League,DEN,Midfilder,"2,340,000",26,197,3,200
709,Everton,Premier League,ENG,Midfilder,"2,340,000",31,353,13,366
710,Villarreal,La Liga,ESP,Forward,"2,297,000",30,372,17,389
711,Man UFC,Premier League,NED,Forward,"2,288,000",30,329,13,342
712,Benfica,Primiera Liga,POR,Midfilder,"2,264,000",29,283,50,333
713,OM,Ligue 1 Uber Eats,FRA,Midfilder,"2,242,000",23,151,6,157
714,Torino,Serie A,NED,Defender,"2,242,000",22,153,0,153
715,Wolves,Premier League,ESP,Midfilder,"2,236,000",26,256,9,265
716,PSG,Ligue 1 Uber Eats,ESP,Goalkeeper,"2,235,000",29,204,1,205
717,Vigo,La Liga,ESP,Forward,"2,235,000",35,489,18,507
718,Vigo,La Liga,ESP,Defender,"2,235,000",31,375,0,375
719,OL,Ligue 1 Uber Eats,CRO,Defender,"2,235,000",33,371,70,441
720,Lazio,Serie A,ITA,Midfilder,"2,233,000",28,212,0,212
721,Fiorentina,Serie A,ITA,Midfilder,"2,233,000",25,154,4,158
722,Torino,Serie A,POL,Midfilder,"2,233,000",27,265,41,306
723,Atalanta,Serie A,ITA,Defender,"2,211,000",18,19,1,20
724,Capitoline,Serie A,TUR,Defender,"2,207,000",25,220,32,252
725,Inter,Serie A,ITA,Defender,"2,207,000",32,316,36,352
726,Parthenope,Serie A,SVK,Midfilder,"2,207,000",27,309,40,349
727,Atalanta,Serie A,BRA,Midfilder,"2,207,000",23,91,0,91
728,Real Hispalis,La Liga,ARG,Midfilder,"2,199,000",28,258,24,282
729,A. Bilbao,La Liga,ESP,Goalkeeper,"2,195,000",25,211,25,236
730,Everton,Premier League,ENG,Midfilder,"2,184,000",24,142,0,142
731,FC Augsburg,Bundesliga,GER,Forward,"2,155,000",24,155,0,155
732,Hoffenheim,Bundesliga,TOG,Midfilder,"2,154,000",28,222,26,248
733,Vigo,La Liga,ARG,Midfilder,"2,149,000",28,182,4,186
734,Fiorentina,Serie A,CRO,Midfilder,"2,149,000",24,182,33,215
735,OL,Ligue 1 Uber Eats,ARG,Defender,"2,149,000",30,314,40,354
736,Schalke 04,Bundesliga,GER,Goalkeeper,"2,149,000",30,302,0,302
737,Borussia M'gladbach,Bundesliga,AUT,Defender,"2,149,000",30,342,37,379
738,Borussia Dortmund,Bundesliga,USA,Midfilder,"2,149,000",19,63,12,75
739,FC Bayern,Bundesliga,CRO,Defender,"2,149,000",22,56,5,61
740,FC Augsburg,Bundesliga,GER,Defender,"2,149,000",32,295,0,295
741,Borussia M'gladbach,Bundesliga,GER,Defender,"2,149,000",26,203,0,203
742,Bologna,Serie A,NED,Forward,"2,149,000",21,85,0,85
743,RB Leipzig,Bundesliga,GER,Defender,"2,149,000",25,135,7,142
744,Eintracht Frankfurt,Bundesliga,ARG,Forward,"2,149,000",29,264,9,273
745,FC Bayern,Bundesliga,NED,Defender,"2,149,000",32,333,91,424
746,FC Bayern,Bundesliga,SEN,Defender,"2,149,000",30,247,13,260
747,Real San Sebastian,La Liga,ESP,Midfilder,"2,143,000",26,225,11,236
748,Villarreal,La Liga,ESP,Defender,"2,129,000",37,550,58,608
749,OM,Ligue 1 Uber Eats,FRA,Defender,"2,095,000",29,218,4,222
750,Sevilla,La Liga,MAR,Goalkeeper,"2,084,000",31,247,43,290
751,Getafe,La Liga,ESP,Goalkeeper,"2,080,000",35,375,1,376
752,Arsenal,Premier League,USA,Goalkeeper,"2,080,000",28,129,17,146
753,Nottm Forest,Premier League,NGA,Midfilder,"2,080,000",24,151,7,158
754,Nottm Forest,Premier League,WAL,Defender,"2,080,000",21,34,21,55
755,Fulham,Premier League,ENG,Midfilder,"2,080,000",27,191,0,191
756,Man City,Premier League,ENG,Goalkeeper,"2,080,000",37,472,4,476
757,Everton,Premier League,ENG,Midfilder,"2,080,000",21,84,0,84
758,Leeds,Premier League,GER,Defender,"2,080,000",26,211,8,219
759,Leeds,Premier League,USA,Midfilder,"2,080,000",21,127,22,149
760,Southampton,Premier League,FRA,Forward,"2,080,000",20,38,0,38
761,Southampton,Premier League,IRL,Goalkeeper,"2,080,000",20,84,10,94
762,Crystal Palace,Premier League,ENG,Defender,"2,080,000",32,391,0,391
763,Man City,Premier League,ESP,Defender,"2,080,000",22,123,0,123
764,Brentford,Premier League,ENG,Defender,"2,080,000",25,196,0,196
765,Brentford,Premier League,GER,Midfilder,"2,080,000",24,138,0,138
766,Crystal Palace,Premier League,GHA,Forward,"2,080,000",30,387,81,468
767,Fulham,Premier League,WAL,Forward,"2,080,000",25,169,39,208
768,Brentford,Premier League,DEN,Midfilder,"2,080,000",28,239,17,256
769,Man UFC,Premier League,SWE,Midfilder,"2,080,000",20,28,5,33
770,Leeds,Premier League,FRA,Goalkeeper,"2,080,000",22,115,0,115
771,Wolves,Premier League,POR,Goalkeeper,"2,080,000",29,247,0,247
772,Nottm Forest,Premier League,WAL,Forward,"2,080,000",21,97,13,110
773,Southampton,Premier League,FRA,Midfilder,"2,080,000",23,96,0,96
774,Brentford,Premier League,SWE,Defender,"2,080,000",31,336,27,363
775,Arsenal,Premier League,FRA,Defender,"2,080,000",21,90,5,95
776,Everton,Premier League,BIH,Goalkeeper,"2,080,000",35,346,63,409
777,Wolves,Premier League,POR,Forward,"2,080,000",22,88,3,91
778,Everton,Premier League,SCO,Defender,"2,080,000",20,19,10,29
779,Southampton,Premier League,FRA,Defender,"2,080,000",24,113,0,113
780,Bournemouth,Premier League,BFA,Forward,"2,080,000",20,54,8,62
781,Arsenal,Premier League,ENG,Defender,"2,080,000",26,112,0,112
782,Brentford,Premier League,ESP,Goalkeeper,"2,080,000",26,232,1,233
783,Leeds,Premier League,NED,Defender,"2,080,000",23,68,0,68
784,Newcastle,Premier League,ESP,Defender,"2,080,000",28,202,0,202
785,Southampton,Premier League,BEL,Midfilder,"2,080,000",18,0,0,0
786,Southampton,Premier League,GHA,Defender,"2,080,000",23,123,0,123
787,Everton,Premier League,JAM,Midfilder,"2,080,000",26,256,0,256
788,Brentford,Premier League,ALB,Goalkeeper,"2,080,000",27,175,19,194
789,Man UFC,Premier League,ENG,Goalkeeper,"2,080,000",29,272,9,281
790,Arsenal,Premier League,ENG,Midfilder,"2,080,000",22,67,0,67
791,Newcastle,Premier League,WAL,Defender,"2,080,000",30,231,5,236
792,Southampton,Premier League,GER,Defender,"2,080,000",20,66,0,66
793,Nottm Forest,Premier League,SEN,Defender,"2,080,000",32,451,77,528
794,Bournemouth,Premier League,IRL,Goalkeeper,"2,080,000",35,403,50,453
795,Crystal Palace,Premier League,ENG,Defender,"2,080,000",23,66,2,68
796,Fiorentina,Serie A,GHA,Midfilder,"2,078,000",29,269,9,278
797,Salernitana,Serie A,ITA,Defender,"2,073,000",35,517,54,571
798,Rennes,Ligue 1 Uber Eats,CMR,Forward,"2,063,000",29,338,50,388
799,FC Porto,Primiera Liga,COL,Midfilder,"2,059,000",31,322,43,365
800,Leeds,Premier League,ESP,Goalkeeper,"2,045,000",32,183,0,183
801,SC Freiburg,Bundesliga,GER,Defender,"2,017,000",28,299,46,345
802,Borussia M'gladbach,Bundesliga,FRA,Midfilder,"1,995,000",21,82,0,82
803,Parthenope,Serie A,KOS,Defender,"1,991,000",28,254,48,302
804,Atalanta,Serie A,NGA,Midfilder,"1,991,000",24,167,4,171
805,Atalanta,Serie A,COL,Forward,"1,991,000",31,338,44,382
806,Valencia,La Liga,URU,Forward,"1,980,000",35,479,133,612
807,Hoffenheim,Bundesliga,GER,Defender,"1,977,000",30,343,0,343
808,Real Hispalis,La Liga,POR,Midfilder,"1,966,000",30,303,73,376
809,Torino,Serie A,AUT,Defender,"1,966,000",26,209,36,245
810,OM,Ligue 1 Uber Eats,FRA,Defender,"1,950,000",28,228,0,228
811,Real San Sebastian,La Liga,ESP,Forward,"1,933,000",25,237,21,258
812,Inter,Serie A,BRA,Defender,"1,914,000",28,202,0,202
813,Fiorentina,Serie A,ITA,Defender,"1,914,000",30,323,13,336
814,Torino,Serie A,FRA,Forward,"1,914,000",24,144,0,144
815,Real Hispalis,La Liga,ARG,Defender,"1,914,000",31,261,29,290
816,Lazio,Serie A,ROU,Defender,"1,914,000",35,432,14,446
817,Fiorentina,Serie A,CIV,Forward,"1,914,000",24,193,14,207
818,Lazio,Serie A,ALG,Defender,"1,914,000",26,129,12,141
819,Real San Sebastian,La Liga,ESP,Goalkeeper,"1,898,000",27,226,0,226
820,SV Werder,Bundesliga,CZE,Goalkeeper,"1,896,000",30,267,14,281
821,SV Werder,Bundesliga,GER,Midfilder,"1,896,000",28,274,0,274
822,Mainz 05,Bundesliga,ESP,Defender,"1,892,000",25,209,0,209
823,Troyes,Ligue 1 Uber Eats,POR,Midfilder,"1,892,000",26,181,2,183
824,Salento,Serie A,CRO,Defender,"1,892,000",24,101,5,106
825,1. FC Koln,Bundesliga,SWE,Forward,"1,892,000",31,334,9,343
826,Borussia M'gladbach,Bundesliga,JPN,Defender,"1,892,000",25,125,12,137
827,A. Bilbao,La Liga,ESP,Midfilder,"1,890,000",29,408,2,410
828,Real Hispalis,La Liga,ESP,Forward,"1,889,000",29,324,0,324
829,Real San Sebastian,La Liga,JPN,Midfilder,"1,881,000",21,157,18,175
830,Parthenope,Serie A,CMR,Midfilder,"1,879,000",26,203,42,245
831,Fiorentina,Serie A,FRA,Forward,"1,879,000",24,184,4,188
832,Fiorentina,Serie A,BRA,Forward,"1,879,000",24,144,0,144
833,Udinese,Serie A,FRA,Forward,"1,871,000",29,324,10,334
834,Eintracht Frankfurt,Bundesliga,SUI,Midfilder,"1,868,000",25,203,30,233
835,AS Monaco,Ligue 1 Uber Eats,SEN,Defender,"1,857,000",23,118,24,142
836,LOSC,Ligue 1 Uber Eats,CAN,Forward,"1,857,000",22,141,32,173
837,LOSC,Ligue 1 Uber Eats,ALG,Forward,"1,856,000",25,128,19,147
838,Benfica,Primiera Liga,BRA,Midfilder,"1,854,000",25,144,7,151
839,Cadiz,La Liga,ARG,Midfilder,"1,835,000",29,231,0,231
840,OGC Nice,Ligue 1 Uber Eats,FRA,Forward,"1,834,000",28,271,0,271
841,Bournemouth,Premier League,ENG,Midfilder,"1,820,000",25,221,1,222
842,Leicester,Premier League,WAL,Goalkeeper,"1,820,000",29,79,26,105
843,Newcastle,Premier League,SWE,Defender,"1,820,000",28,230,42,272
844,Bournemouth,Premier League,ENG,Defender,"1,820,000",23,135,0,135
845,Newcastle,Premier League,ENG,Defender,"1,820,000",27,265,0,265
846,Rennes,Ligue 1 Uber Eats,WAL,Defender,"1,820,000",24,85,28,113
847,Leeds,Premier League,ENG,Defender,"1,820,000",31,458,0,458
848,Fulham,Premier League,NED,Defender,"1,820,000",26,188,13,201
849,Nottm Forest,Premier League,ENG,Defender,"1,820,000",27,240,0,240
850,Bournemouth,Premier League,WAL,Midfilder,"1,820,000",25,113,21,134
851,Brentford,Premier League,ENG,Midfilder,"1,820,000",21,121,0,121
852,Brentford,Premier League,NGA,Midfilder,"1,820,000",24,119,7,126
853,Aston Villa,Premier League,SWE,Goalkeeper,"1,820,000",32,243,60,303
854,Fulham,Premier League,JAM,Defender,"1,820,000",29,326,16,342
855,Bournemouth,Premier League,SCO,Midfilder,"1,820,000",27,249,31,280
856,Wolves,Premier League,FRA,Defender,"1,820,000",21,68,0,68
857,Bournemouth,Premier League,ENG,Defender,"1,820,000",29,221,0,221
858,Leeds,Premier League,SCO,Defender,"1,820,000",31,321,14,335
859,Brighton,Premier League,SCO,Midfilder,"1,820,000",21,36,15,51
860,Everton,Premier League,BEL,Defender,"1,820,000",21,63,1,64
861,Tottenham,Premier League,ENG,Defender,"1,820,000",23,23,0,23
862,Bournemouth,Premier League,WAL,Defender,"1,820,000",24,121,32,153
863,AS Monaco,Ligue 1 Uber Eats,FRA,Defender,"1,820,000",23,132,0,132
864,Brest,Ligue 1 Uber Eats,FRA,Midfilder,"1,820,000",29,257,0,257
865,Man UFC,Premier League,POR,Defender,"1,820,000",23,99,5,104
866,Brentford,Premier League,SCO,Defender,"1,820,000",20,76,4,80
867,Spezia,Serie A,WAL,Defender,"1,820,000",21,71,36,107
868,Aston Villa,Premier League,COL,Forward,"1,820,000",18,74,3,77
869,Brentford,Premier League,ENG,Midfilder,"1,820,000",23,102,0,102
870,Fulham,Premier League,USA,Defender,"1,820,000",34,427,46,473
871,Real Hispalis,La Liga,ESP,Midfilder,"1,815,000",41,715,51,766
872,Real San Sebastian,La Liga,FRA,Defender,"1,810,000",25,191,0,191
873,Rennes,Ligue 1 Uber Eats,FRA,Midfilder,"1,802,000",28,275,0,275
874,PSG,Ligue 1 Uber Eats,POR,Defender,"1,798,000",20,74,15,89
875,RB Leipzig,Bundesliga,SVN,Midfilder,"1,797,000",31,344,28,372
876,Mainz 05,Bundesliga,FRA,Forward,"1,795,000",28,247,0,247
877,Hertha Berlin,Bundesliga,MNE,Forward,"1,793,000",32,330,63,393
878,Mallorca,La Liga,SWE,Defender,"1,793,000",28,257,46,303
879,Bologna,Serie A,ITA,Forward,"1,767,000",30,352,3,355
880,Bologna,Serie A,ITA,Midfilder,"1,767,000",31,352,9,361
881,Spezia,Serie A,UZB,Forward,"1,763,000",27,217,57,274
882,Cremonese,Serie A,ITA,Midfilder,"1,759,000",27,217,0,217
883,Milan,Serie A,BIH,Midfilder,"1,759,000",28,264,27,291
884,Bologna,Serie A,ITA,Midfilder,"1,759,000",25,207,2,209
885,Montpellier,Ligue 1 Uber Eats,FRA,Midfilder,"1,759,000",30,310,0,310
886,Spezia,Serie A,SWE,Midfilder,"1,754,000",33,363,66,429
887,FC Porto,Primiera Liga,POR,Midfilder,"1,742,000",27,240,7,247
888,FC Porto,Primiera Liga,ESP,Defender,"1,732,000",35,350,0,350
889,Girona,La Liga,UKR,Midfilder,"1,726,000",24,156,40,196
890,Hoffenheim,Bundesliga,CZE,Defender,"1,724,000",30,306,48,354
891,Hoffenheim,Bundesliga,DEN,Defender,"1,724,000",26,225,11,236
892,Eintracht Frankfurt,Bundesliga,GER,Midfilder,"1,724,000",31,250,0,250
893,Sampdoria,Serie A,FRA,Midfilder,"1,724,000",23,89,0,89
894,R. Madrid,La Liga,ESP,Defender,"1,724,000",25,125,0,125
895,Real San Sebastian,La Liga,ESP,Midfilder,"1,722,000",25,214,4,218
896,VfL Wolfsburg,Bundesliga,AUT,Midfilder,"1,719,000",21,139,1,140
897,Borussia M'gladbach,Bundesliga,AUT,Forward,"1,719,000",23,156,0,156
898,Borussia M'gladbach,Bundesliga,GER,Defender,"1,719,000",19,36,0,36
899,VfL Wolfsburg,Bundesliga,GER,Defender,"1,719,000",24,143,4,147
900,VfL Wolfsburg,Bundesliga,DEN,Forward,"1,719,000",23,102,15,117
901,Mainz 05,Bundesliga,SUI,Defender,"1,719,000",26,225,22,247
902,Borussia Dortmund,Bundesliga,SUI,Goalkeeper,"1,719,000",24,162,3,165
903,Hoffenheim,Bundesliga,DEN,Midfilder,"1,718,000",23,89,6,95
904,Benfica,Primiera Liga,ARG,Defender,"1,711,000",34,351,91,442
905,RB Leipzig,Bundesliga,HUN,Midfilder,"1,695,000",21,133,24,157
906,AS Monaco,Ligue 1 Uber Eats,BRA,Defender,"1,693,000",25,155,0,155
907,SV Werder,Bundesliga,GER,Midfilder,"1,681,000",29,266,0,266
908,SV Werder,Bundesliga,GER,Defender,"1,681,000",28,218,0,218
909,Fulham,Premier League,COD,Midfilder,"1,664,000",30,261,32,293
910,Capitoline,Serie A,BRA,Defender,"1,655,000",23,92,0,92
911,Milan,Serie A,DEN,Defender,"1,655,000",33,385,119,504
912,Milan,Serie A,SWE,Forward,"1,655,000",40,633,121,754
913,Parthenope,Serie A,URU,Defender,"1,655,000",24,121,6,127
914,Bologna,Serie A,CHI,Defender,"1,655,000",35,436,152,588
915,Parthenope,Serie A,MKD,Midfilder,"1,655,000",22,177,42,219
916,Atalanta,Serie A,NED,Midfilder,"1,655,000",24,175,9,184
917,Fiorentina,Serie A,MAR,Midfilder,"1,655,000",26,181,36,217
918,Fiorentina,Serie A,BRA,Defender,"1,655,000",23,116,0,116
919,Famalicao,Primiera Liga,GNB,Midfilder,"1,650,000",30,211,21,232
920,Vigo,La Liga,GHA,Defender,"1,634,000",26,194,8,202
921,Espanyol,La Liga,ESP,Midfilder,"1,632,000",28,367,0,367
922,Vigo,La Liga,SUI,Forward,"1,632,000",30,287,86,373
923,Sevilla,La Liga,ARG,Defender,"1,627,000",30,343,41,384
924,Sporting CP,Primiera Liga,URU,Defender,"1,623,000",31,317,47,364
925,Udinese,Serie A,NGA,Forward,"1,612,000",26,169,4,173
926,LOSC,Ligue 1 Uber Eats,FRA,Midfilder,"1,610,000",32,441,0,441
927,Bologna,Serie A,CRO,Midfilder,"1,598,000",24,170,1,171
928,Villarreal,La Liga,FRA,Midfilder,"1,596,000",34,418,7,425
929,Sassuolo,Serie A,ITA,Goalkeeper,"1,595,000",35,552,0,552
930,AJ Auxerre,Ligue 1 Uber Eats,ROU,Goalkeeper,"1,595,000",25,81,0,81
931,Empoli,Serie A,ROU,Midfilder,"1,595,000",26,252,41,293
932,Lazio,Serie A,ESP,Defender,"1,595,000",29,214,0,214
933,Salernitana,Serie A,ITA,Midfilder,"1,595,000",24,177,0,177
934,Brianza,Serie A,ITA,Goalkeeper,"1,595,000",28,252,2,254
935,Lazio,Serie A,ITA,Defender,"1,595,000",23,70,1,71
936,Torino,Serie A,ITA,Midfilder,"1,595,000",21,97,0,97
937,Atalanta,Serie A,NED,Midfilder,"1,595,000",31,388,27,415
938,Juventus,Serie A,ITA,Defender,"1,595,000",24,171,1,172
939,Salernitana,Serie A,ARG,Defender,"1,595,000",35,383,10,393
940,Lazio,Serie A,ITA,Defender,"1,595,000",24,132,0,132
941,Lazio,Serie A,ITA,Goalkeeper,"1,595,000",28,232,0,232
942,Juventus,Serie A,ITA,Midfilder,"1,595,000",21,42,0,42
943,Bologna,Serie A,ITA,Defender,"1,595,000",26,135,0,135
944,Torino,Serie A,ALB,Goalkeeper,"1,595,000",33,279,73,352
945,Torino,Serie A,NGA,Defender,"1,595,000",25,165,29,194
946,Parthenope,Serie A,BRA,Defender,"1,595,000",31,220,4,224
947,Atalanta,Serie A,ITA,Defender,"1,595,000",31,360,8,368
948,Empoli,Serie A,ITA,Defender,"1,595,000",32,232,0,232
949,Brianza,Serie A,ITA,Midfilder,"1,595,000",25,204,14,218
950,Atalanta,Serie A,CRO,Midfilder,"1,595,000",27,258,40,298
951,Milan,Serie A,BRA,Forward,"1,595,000",31,214,0,214
952,Milan,Serie A,ITA,Midfilder,"1,595,000",23,117,1,118
953,Brianza,Serie A,ITA,Midfilder,"1,595,000",20,46,0,46
954,FC Porto,Primiera Liga,POR,Goalkeeper,"1,585,000",22,94,5,99
955,RC Lens,Ligue 1 Uber Eats,CIV,Midfilder,"1,583,000",27,239,6,245
956,OM,Ligue 1 Uber Eats,CHI,Forward,"1,582,000",33,521,152,673
957,OM,Ligue 1 Uber Eats,POR,Forward,"1,582,000",22,56,0,56
958,Bologna,Serie A,NED,Midfilder,"1,579,000",25,144,1,145
959,FC Porto,Primiera Liga,IRN,Forward,"1,574,000",30,248,58,306
960,Getafe,La Liga,ESP,Midfilder,"1,572,000",24,120,1,121
961,A. Madrid,La Liga,MOZ,Defender,"1,562,000",28,150,35,185
962,Nottm Forest,Premier League,ENG,Defender,"1,560,000",31,403,0,403
963,Brentford,Premier League,IRN,Forward,"1,560,000",28,263,31,294
964,Leicester,Premier League,ENG,Goalkeeper,"1,560,000",32,444,0,444
965,Bournemouth,Premier League,ENG,Defender,"1,560,000",31,351,0,351
966,Southampton,Premier League,ARG,Goalkeeper,"1,560,000",40,369,5,374
967,Crystal Palace,Premier League,FRA,Midfilder,"1,560,000",20,36,0,36
968,Wolves,Premier League,IRL,Defender,"1,560,000",21,65,6,71
969,Nottm Forest,Premier League,BRA,Midfilder,"1,560,000",21,74,0,74
970,Brentford,Premier League,JAM,Defender,"1,560,000",29,360,5,365
971,Reims,Ligue 1 Uber Eats,ENG,Forward,"1,560,000",21,25,0,25
972,Crystal Palace,Premier League,ENG,Defender,"1,560,000",21,22,0,22
973,Tottenham,Premier League,SEN,Midfilder,"1,560,000",19,66,8,74
974,Chelsea,Premier League,ENG,Goalkeeper,"1,560,000",30,225,0,225
975,OM,Ligue 1 Uber Eats,POR,Defender,"1,560,000",22,72,0,72
976,West Ham,Premier League,ENG,Midfilder,"1,560,000",23,144,0,144
977,Bournemouth,Premier League,ENG,Midfilder,"1,560,000",22,62,0,62
978,Wolves,Premier League,ENG,Defender,"1,560,000",25,122,0,122
979,Southampton,Premier League,ENG,Defender,"1,560,000",24,217,0,217
980,Fulham,Premier League,USA,Defender,"1,560,000",25,164,28,192
981,West Ham,Premier League,ENG,Defender,"1,560,000",22,38,0,38
982,Liverpool,Premier League,IRL,Goalkeeper,"1,560,000",23,4,8,12
983,Newcastle,Premier League,ENG,Midfilder,"1,560,000",24,143,0,143
984,Liverpool,Premier League,ENG,Forward,"1,560,000",20,42,0,42
985,Bournemouth,Premier League,ENG,Midfilder,"1,560,000",27,225,0,225
986,OGC Nice,Ligue 1 Uber Eats,ENG,Defender,"1,560,000",28,325,0,325
987,Newcastle,Premier League,GER,Goalkeeper,"1,560,000",29,206,0,206
988,Fulham,Premier League,SCO,Midfilder,"1,560,000",31,375,2,377
989,FC Augsburg,Bundesliga,GER,Midfilder,"1,552,000",32,360,1,361
990,Eintracht Frankfurt,Bundesliga,FRA,Defender,"1,552,000",26,110,0,110
991,Benfica,Primiera Liga,BRA,Defender,"1,549,000",27,124,2,126
992,Schalke 04,Bundesliga,GER,Goalkeeper,"1,548,000",33,275,0,275
993,Torino,Serie A,SRB,Forward,"1,548,000",26,129,35,164
994,Mainz 05,Bundesliga,KOR,Midfilder,"1,548,000",30,262,63,325
995,OL,Ligue 1 Uber Eats,FRA,Forward,"1,548,000",19,54,0,54
996,1. FC Koln,Bundesliga,GER,Forward,"1,548,000",31,278,1,279
997,FC Augsburg,Bundesliga,GER,Defender,"1,548,000",34,435,0,435
998,RC Lens,Ligue 1 Uber Eats,FRA,Midfilder,"1,548,000",26,234,0,234
999,OGC Nice,Ligue 1 Uber Eats,ALG,Defender,"1,546,000",26,141,20,161
1000,Troyes,Ligue 1 Uber Eats,FRA,Midfilder,"1,546,000",24,85,0,85
1001,FC Nantes,Ligue 1 Uber Eats,NGA,Midfilder,"1,546,000",27,256,53,309
1002,Real San Sebastian,La Liga,ESP,Midfilder,"1,545,000",23,132,1,133
1003,Milan,Serie A,POR,Forward,"1,543,000",23,138,9,147
1004,Lazio,Serie A,CRO,Midfilder,"1,543,000",25,204,2,206
1005,Sevilla,La Liga,BRA,Midfilder,"1,534,000",35,393,0,393
1006,Sporting CP,Primiera Liga,ESP,Goalkeeper,"1,525,000",35,361,0,361
1007,Villarreal,La Liga,ARG,Defender,"1,505,000",24,70,15,85
1008,VfL Wolfsburg,Bundesliga,POL,Midfilder,"1,505,000",20,108,3,111
1009,Rennes,Ligue 1 Uber Eats,CRO,Midfilder,"1,503,000",24,156,8,164
1010,Benfica,Primiera Liga,NOR,Midfilder,"1,502,000",26,330,8,338
1011,Elche,La Liga,ARG,Forward,"1,482,000",25,184,0,184
1012,Real Hispalis,La Liga,ITA,Defender,"1,474,000",25,125,1,126
1013,Salernitana,Serie A,MEX,Goalkeeper,"1,473,000",37,595,128,723
1014,LOSC,Ligue 1 Uber Eats,BRA,Defender,"1,472,000",32,238,0,238
1015,Mainz 05,Bundesliga,GER,Midfilder,"1,462,000",28,248,0,248
1016,Real San Sebastian,La Liga,ESP,Defender,"1,457,000",28,229,0,229
1017,Brentford,Premier League,COD,Midfilder,"1,456,000",26,209,6,215
1018,Brentford,Premier League,GRN,Midfilder,"1,456,000",24,88,3,91
1019,Elche,La Liga,ESP,Defender,"1,444,000",25,184,0,184
1020,LOSC,Ligue 1 Uber Eats,POR,Defender,"1,444,000",38,593,50,643
1021,Benfica,Primiera Liga,POR,Forward,"1,441,000",29,293,25,318
1022,Bologna,Serie A,ITA,Defender,"1,440,000",34,405,6,411
1023,Empoli,Serie A,ALB,Defender,"1,440,000",25,137,27,164
1024,Lazio,Serie A,MNE,Defender,"1,440,000",29,311,49,360
1025,Salernitana,Serie A,ITA,Goalkeeper,"1,440,000",31,199,0,199
1026,Spezia,Serie A,GRE,Defender,"1,440,000",24,104,1,105
1027,Bologna,Serie A,POL,Goalkeeper,"1,440,000",31,286,7,293
1028,Atalanta,Serie A,ITA,Defender,"1,440,000",30,280,13,293
1029,A. Bilbao,La Liga,ESP,Midfilder,"1,438,000",20,68,0,68
1030,Getafe,La Liga,URU,Defender,"1,436,000",22,52,0,52
1031,Empoli,Serie A,ITA,Midfilder,"1,435,000",27,142,0,142
1032,Girona,La Liga,URU,Forward,"1,435,000",35,496,50,546
1033,Vallecano,La Liga,FRA,Defender,"1,435,000",31,327,0,327
1034,FC Porto,Primiera Liga,BRA,Forward,"1,423,000",22,71,0,71
1035,Schalke 04,Bundesliga,JPN,Defender,"1,419,000",34,355,119,474
1036,Villarreal,La Liga,ESP,Defender,"1,414,000",26,234,0,234
1037,Benfica,Primiera Liga,ESP,Defender,"1,412,000",26,264,0,264
1038,Tottenham,Premier League,ESP,Defender,"1,412,000",22,109,1,110
1039,Mallorca,La Liga,BIH,Defender,"1,410,000",24,100,18,118
1040,Sassuolo,Serie A,FRA,Forward,"1,405,000",23,99,0,99
1041,Real Hispalis,La Liga,ESP,Midfilder,"1,401,000",31,381,10,391
1042,FC Nantes,Ligue 1 Uber Eats,ALG,Forward,"1,393,000",30,357,11,368
1043,Fiorentina,Serie A,SRB,Forward,"1,384,000",24,175,26,201
1044,Mainz 05,Bundesliga,SUI,Defender,"1,376,000",29,315,31,346
1045,AC Ajaccio,Ligue 1 Uber Eats,MLI,Defender,"1,375,000",27,93,17,110
1046,FC Nantes,Ligue 1 Uber Eats,BRA,Defender,"1,370,000",24,70,0,70
1047,Sporting CP,Primiera Liga,POR,Midfilder,"1,356,000",24,97,2,99
1048,Udinese,Serie A,SVN,Defender,"1,354,000",23,146,31,177
1049,Sassuolo,Serie A,FRA,Forward,"1,354,000",31,321,0,321
1050,Wolves,Premier League,MLI,Midfilder,"1,345,000",21,35,0,35
1051,Hoffenheim,Bundesliga,BIH,Defender,"1,345,000",32,224,35,259
1052,Union Berlin,Bundesliga,CRO,Defender,"1,345,000",27,247,20,267
1053,Sampdoria,Serie A,ARG,Midfilder,"1,345,000",26,183,0,183
1054,Cremonese,Serie A,NGA,Forward,"1,345,000",27,205,3,208
1055,Sevilla,La Liga,ARG,Midfilder,"1,340,000",28,350,10,360
1056,Montpellier,Ligue 1 Uber Eats,FRA,Midfilder,"1,340,000",30,274,0,274
1057,SV Werder,Bundesliga,GER,Forward,"1,334,000",28,276,0,276
1058,FC Porto,Primiera Liga,BRA,Midfilder,"1,334,000",25,125,0,125
1059,Reims,Ligue 1 Uber Eats,SWE,Defender,"1,328,000",23,85,13,98
1060,Sassuolo,Serie A,ALB,Midfilder,"1,328,000",23,187,7,194
1061,Juventus,Serie A,BRA,Forward,"1,328,000",20,53,0,53
1062,Bournemouth,Premier League,URU,Defender,"1,328,000",24,92,24,116
1063,Milan,Serie A,ROU,Goalkeeper,"1,328,000",36,362,73,435
1064,Parthenope,Serie A,GEO,Forward,"1,328,000",21,113,17,130
1065,Capitoline,Serie A,CRO,Midfilder,"1,328,000",25,152,4,156
1066,Espanyol,La Liga,ESP,Midfilder,"1,323,000",28,264,1,265
1067,Bologna,Serie A,COL,Defender,"1,310,000",24,154,7,161
1068,Schalke 04,Bundesliga,CZE,Midfilder,"1,305,000",24,121,31,152
1069,Cremonese,Serie A,FRA,Midfilder,"1,301,000",28,243,0,243
1070,Valencia,La Liga,ESP,Goalkeeper,"1,300,000",31,223,0,223
1071,Chelsea,Premier League,ENG,Forward,"1,300,000",18,3,0,3
1072,Elche,La Liga,ARG,Defender,"1,300,000",33,318,32,350
1073,Man City,Premier League,ENG,Midfilder,"1,300,000",20,7,0,7
1074,Newcastle,Premier League,ENG,Midfilder,"1,300,000",22,45,0,45
1075,Bournemouth,Premier League,ZIM,Defender,"1,300,000",22,42,6,48
1076,Bournemouth,Premier League,ENG,Midfilder,"1,300,000",23,149,0,149
1077,Brighton,Premier League,ESP,Goalkeeper,"1,300,000",24,114,1,115
1078,Man UFC,Premier League,URU,Forward,"1,300,000",20,65,6,71
1079,Bournemouth,Premier League,WAL,Forward,"1,300,000",30,305,26,331
1080,Nottm Forest,Premier League,ENG,Defender,"1,300,000",25,207,0,207
1081,Liverpool,Premier League,ENG,Defender,"1,300,000",25,53,0,53
1082,Nottm Forest,Premier League,ENG,Midfilder,"1,300,000",24,196,0,196
1083,Valladolid,La Liga,BRA,Defender,"1,300,000",26,146,0,146
1084,Wolves,Premier League,POR,Forward,"1,300,000",22,44,0,44
1085,Nottm Forest,Premier League,SCO,Defender,"1,300,000",25,194,26,220
1086,Leeds,Premier League,ENG,Midfilder,"1,300,000",30,274,0,274
1087,Girona,La Liga,ARG,Goalkeeper,"1,300,000",30,116,1,117
1088,Leeds,Premier League,NED,Midfilder,"1,300,000",20,49,0,49
1089,Bournemouth,Premier League,ENG,Midfilder,"1,300,000",32,314,0,314
1090,Brighton,Premier League,ECU,Midfilder,"1,300,000",20,52,28,80
1091,Bournemouth,Premier League,IRL,Goalkeeper,"1,300,000",23,80,3,83
1092,Bournemouth,Premier League,ENG,Defender,"1,300,000",26,212,0,212
1093,Leicester,Premier League,ENG,Defender,"1,300,000",21,46,0,46
1094,Benfica,Primiera Liga,GRE,Goalkeeper,"1,298,000",28,244,27,271
1095,FC Porto,Primiera Liga,BRA,Defender,"1,298,000",29,237,0,237
1096,Capitoline,Serie A,NOR,Forward,"1,296,000",23,135,0,135
1097,Getafe,La Liga,PAR,Defender,"1,293,000",25,124,11,135
1098,BRG,Primiera Liga,POR,Midfilder,"1,293,000",27,240,9,249
1099,Hertha Berlin,Bundesliga,GER,Midfilder,"1,293,000",25,165,4,169
1100,1. FC Koln,Bundesliga,TUN,Midfilder,"1,293,000",27,218,45,263
1101,Mallorca,La Liga,ESP,Defender,"1,293,000",25,163,0,163
1102,Sampdoria,Serie A,GER,Defender,"1,292,000",28,161,0,161
1103,Mainz 05,Bundesliga,GER,Defender,"1,290,000",31,290,0,290
1104,Borussia M'gladbach,Bundesliga,GER,Midfilder,"1,290,000",31,339,2,341
1105,Mainz 05,Bundesliga,GER,Goalkeeper,"1,290,000",27,177,0,177
1106,Vigo,La Liga,ESP,Defender,"1,290,000",27,310,0,310
1107,Elche,La Liga,ESP,Midfilder,"1,290,000",29,285,0,285
1108,Mainz 05,Bundesliga,FRA,Defender,"1,290,000",25,114,0,114
1109,Hoffenheim,Bundesliga,AUT,Midfilder,"1,290,000",23,108,21,129
1110,Schalke 04,Bundesliga,GER,Forward,"1,290,000",34,427,0,427
1111,1. FC Koln,Bundesliga,GER,Forward,"1,290,000",27,258,0,258
1112,Eintracht Frankfurt,Bundesliga,FRA,Forward,"1,290,000",23,100,0,100
1113,Union Berlin,Bundesliga,SUR,Midfilder,"1,290,000",27,198,5,203
1114,Bayer 04,Bundesliga,GER,Midfilder,"1,290,000",27,247,0,247
1115,Hertha Berlin,Bundesliga,NGA,Forward,"1,290,000",24,145,8,153
1116,VfL Wolfsburg,Bundesliga,BRA,Defender,"1,290,000",27,106,0,106
1117,Borussia M'gladbach,Bundesliga,FRA,Midfilder,"1,290,000",22,47,0,47
1118,Milan,Serie A,BEL,Midfilder,"1,290,000",19,68,0,68
1119,VfL Wolfsburg,Bundesliga,FRA,Defender,"1,290,000",23,99,0,99
1120,Bayer 04,Bundesliga,NED,Defender,"1,290,000",21,76,0,76
1121,Mainz 05,Bundesliga,LUX,Midfilder,"1,290,000",22,99,39,138
1122,Schalke 04,Bundesliga,GER,Forward,"1,290,000",31,351,0,351
1123,Bayer 04,Bundesliga,NED,Defender,"1,290,000",22,89,0,89
1124,Bayer 04,Bundesliga,CIV,Defender,"1,290,000",21,81,15,96
1125,Union Berlin,Bundesliga,USA,Forward,"1,290,000",26,182,9,191
1126,Bayer 04,Bundesliga,CZE,Forward,"1,290,000",20,106,18,124
1127,VfL Wolfsburg,Bundesliga,CRO,Defender,"1,290,000",22,85,0,85
1128,Mainz 05,Bundesliga,GER,Forward,"1,290,000",22,83,0,83
1129,OGC Nice,Ligue 1 Uber Eats,BRA,Defender,"1,289,000",38,496,13,509
1130,Hertha Berlin,Bundesliga,GER,Defender,"1,289,000",30,297,7,304
1131,Bayer 04,Bundesliga,NED,Defender,"1,289,000",27,159,0,159
1132,OM,Ligue 1 Uber Eats,ARG,Defender,"1,289,000",23,66,2,68
1133,FC Nantes,Ligue 1 Uber Eats,FRA,Midfilder,"1,287,000",33,494,71,565
1134,Atalanta,Serie A,ARG,Defender,"1,276,000",32,302,0,302
1135,Bologna,Serie A,GAM,Forward,"1,276,000",23,136,27,163
1136,Empoli,Serie A,ITA,Forward,"1,276,000",35,531,2,533
1137,Empoli,Serie A,SUI,Midfilder,"1,276,000",26,200,0,200
1138,Cremonese,Serie A,ROU,Defender,"1,276,000",32,243,75,318
1139,Atalanta,Serie A,NED,Defender,"1,276,000",28,240,13,253
1140,Verona,Serie A,FRA,Forward,"1,276,000",27,218,0,218
1141,Spezia,Serie A,POL,Goalkeeper,"1,276,000",25,179,2,181
1142,Parthenope,Serie A,ITA,Goalkeeper,"1,276,000",27,139,1,140
1143,Empoli,Serie A,SCO,Midfilder,"1,276,000",26,212,0,212
1144,Atalanta,Serie A,ALB,Defender,"1,276,000",29,331,48,379
1145,Inter,Serie A,GER,Defender,"1,276,000",28,238,13,251
1146,Sampdoria,Serie A,ITA,Goalkeeper,"1,276,000",25,178,0,178
1147,Milan,Serie A,ITA,Defender,"1,276,000",22,54,0,54
1148,LOSC,Ligue 1 Uber Eats,FRA,Goalkeeper,"1,273,000",35,513,1,514
1149,Udinese,Serie A,ARG,Defender,"1,268,000",22,65,0,65
1150,Udinese,Serie A,SVN,Midfilder,"1,268,000",24,193,22,215
1151,Leicester,Premier League,BRA,Midfilder,"1,266,000",22,90,0,90
1152,Fulham,Premier League,ISR,Forward,"1,266,000",23,143,31,174
1153,AS Monaco,Ligue 1 Uber Eats,FRA,Defender,"1,256,000",29,244,1,245
1154,Valencia,La Liga,GUI,Midfilder,"1,255,000",19,52,8,60
1155,Sevilla,La Liga,SEN,Midfilder,"1,238,000",23,104,11,115
1156,LOSC,Ligue 1 Uber Eats,FRA,Forward,"1,238,000",26,219,0,219
1157,Rennes,Ligue 1 Uber Eats,FRA,Midfilder,"1,237,000",29,229,0,229
1158,FC Porto,Primiera Liga,SRB,Midfilder,"1,235,000",26,164,17,181
1159,Schalke 04,Bundesliga,COL,Defender,"1,233,000",29,189,9,198
1160,SV Werder,Bundesliga,GER,Defender,"1,233,000",27,212,2,214
1161,Villarreal,La Liga,ESP,Midfilder,"1,232,000",35,523,0,523
1162,Villarreal,La Liga,ESP,Forward,"1,232,000",19,80,4,84
1163,Inter,Serie A,ALB,Midfilder,"1,224,000",20,27,4,31
1164,Salento,Serie A,ITA,Defender,"1,224,000",25,220,0,220
1165,Real Hispalis,La Liga,CHI,Goalkeeper,"1,222,000",39,448,144,592
1166,Sporting CP,Primiera Liga,NED,Defender,"1,219,000",25,169,0,169
1167,VfL Wolfsburg,Bundesliga,EGY,Forward,"1,216,000",23,106,13,119
1168,Sampdoria,Serie A,COL,Defender,"1,216,000",30,293,32,325
1169,Sampdoria,Serie A,ITA,Forward,"1,216,000",30,325,11,336
1170,Hertha Berlin,Bundesliga,GER,Defender,"1,204,000",25,158,0,158
1171,Mallorca,La Liga,ARG,Midfilder,"1,201,000",31,262,2,264
1172,Bologna,Serie A,FRA,Defender,"1,198,000",30,165,0,165
1173,Union Berlin,Bundesliga,HUN,Midfilder,"1,197,000",23,117,20,137
1174,Montpellier,Ligue 1 Uber Eats,FRA,Forward,"1,186,000",32,356,0,356
1175,Sporting CP,Primiera Liga,ESP,Defender,"1,184,000",27,214,4,218
1176,Hoffenheim,Bundesliga,GER,Midfilder,"1,182,000",24,105,0,105
1177,LOSC,Ligue 1 Uber Eats,FRA,Midfilder,"1,178,000",32,326,4,330
1178,A. Bilbao,La Liga,ESP,Midfilder,"1,177,000",21,130,0,130
1179,Sporting CP,Primiera Liga,ENG,Forward,"1,171,000",23,120,0,120
1180,Brighton,Premier League,POL,Midfilder,"1,170,000",23,173,20,193
1181,OGC Nice,Ligue 1 Uber Eats,NED,Defender,"1,169,000",25,220,1,221
1182,Sevilla,La Liga,ESP,Midfilder,"1,163,000",27,252,0,252
1183,Sevilla,La Liga,MEX,Defender,"1,163,000",29,298,71,369
1184,Schalke 04,Bundesliga,GER,Midfilder,"1,161,000",32,376,0,376
1185,Schalke 04,Bundesliga,URU,Midfilder,"1,161,000",23,88,0,88
1186,Mainz 05,Bundesliga,GER,Defender,"1,161,000",28,224,0,224
1187,Schalke 04,Bundesliga,GER,Midfilder,"1,161,000",32,354,0,354
1188,Schalke 04,Bundesliga,GER,Midfilder,"1,161,000",29,270,0,270
1189,Bayer 04,Bundesliga,NED,Defender,"1,161,000",24,64,3,67
1190,Atletico Pamplona,La Liga,ESP,Goalkeeper,"1,141,000",31,362,0,362
1191,Villarreal,La Liga,NGA,Midfilder,"1,141,000",23,139,24,163
1192,Real Hispalis,La Liga,ESP,Forward,"1,138,000",29,294,1,295
1193,Eintracht Frankfurt,Bundesliga,COL,Forward,"1,137,000",26,180,20,200
1194,Montpellier,Ligue 1 Uber Eats,FRA,Defender,"1,135,000",32,309,29,338
1195,RC Lens,Ligue 1 Uber Eats,FRA,Midfilder,"1,134,000",24,123,0,123
1196,FC Nantes,Ligue 1 Uber Eats,FRA,Defender,"1,134,000",34,377,0,377
1197,Salento,Serie A,FRA,Forward,"1,134,000",25,185,0,185
1198,Rennes,Ligue 1 Uber Eats,FRA,Forward,"1,127,000",22,84,0,84
1199,Brentford,Premier League,DEN,Defender,"1,121,000",32,340,35,375
1200,Sampdoria,Serie A,ITA,Defender,"1,121,000",27,217,0,217
1201,Sassuolo,Serie A,BRA,Defender,"1,121,000",24,117,0,117
1202,Hertha Berlin,Bundesliga,GER,Forward,"1,121,000",31,351,0,351
1203,VfB Stuttgart,Bundesliga,GRE,Defender,"1,121,000",24,92,13,105
1204,Salento,Serie A,MAR,Midfilder,"1,121,000",24,120,0,120
1205,Fiorentina,Serie A,ITA,Goalkeeper,"1,121,000",35,446,28,474
1206,Sassuolo,Serie A,ITA,Midfilder,"1,121,000",22,149,3,152
1207,Brighton,Premier League,GER,Forward,"1,121,000",26,220,0,220
1208,Rennes,Ligue 1 Uber Eats,FRA,Forward,"1,121,000",20,69,0,69
1209,Milan,Serie A,ITA,Goalkeeper,"1,121,000",39,418,0,418
1210,Verona,Serie A,ITA,Forward,"1,121,000",30,386,7,393
1211,Mainz 05,Bundesliga,AUT,Forward,"1,118,000",30,332,18,350
1212,Mainz 05,Bundesliga,DEN,Forward,"1,118,000",26,190,1,191
1213,Empoli,Serie A,ITA,Defender,"1,116,000",25,134,0,134
1214,A. Bilbao,La Liga,ESP,Defender,"1,116,000",27,269,0,269
1215,Udinese,Serie A,MKD,Forward,"1,116,000",32,344,46,390
1216,Verona,Serie A,BIH,Forward,"1,116,000",32,410,15,425
1217,Almeria,La Liga,COL,Forward,"1,107,000",24,219,3,222
1218,Real San Sebastian,La Liga,ESP,Midfilder,"1,104,000",20,80,0,80
1219,Sampdoria,Serie A,SRB,Midfilder,"1,104,000",30,298,35,333
1220,Fiorentina,Serie A,ARG,Defender,"1,103,000",26,105,11,116
1221,Atalanta,Serie A,DEN,Defender,"1,103,000",25,179,29,208
1222,Milan,Serie A,SEN,Defender,"1,103,000",25,118,13,131
1223,Torino,Serie A,ITA,Forward,"1,103,000",21,49,1,50
1224,OM,Ligue 1 Uber Eats,UKR,Midfilder,"1,103,000",29,313,49,362
1225,Udinese,Serie A,ESP,Forward,"1,103,000",28,292,4,296
1226,Spezia,Serie A,NED,Goalkeeper,"1,103,000",31,293,11,304
1227,Milan,Serie A,BEL,Defender,"1,103,000",23,141,9,150
1228,Lazio,Serie A,POR,Goalkeeper,"1,103,000",23,66,0,66
1229,Udinese,Serie A,ARG,Defender,"1,103,000",31,342,19,361
1230,Fiorentina,Serie A,ITA,Forward,"1,103,000",30,269,0,269
1231,OGC Nice,Ligue 1 Uber Eats,FRA,Midfilder,"1,096,000",21,86,0,86
1232,R. Madrid,La Liga,UKR,Goalkeeper,"1,090,000",23,77,7,84
1233,A. Madrid,La Liga,ARG,Defender,"1,090,000",24,112,17,129
1234,FC Nantes,Ligue 1 Uber Eats,EGY,Forward,"1,087,000",24,148,21,169
1235,Brianza,Serie A,ITA,Defender,"1,086,000",31,252,0,252
1236,Brianza,Serie A,ITA,Defender,"1,086,000",27,257,0,257
1237,OGC Nice,Ligue 1 Uber Eats,FRA,Defender,"1,078,000",22,81,0,81
1238,Sporting CP,Primiera Liga,POR,Defender,"1,077,000",34,293,19,312
1239,FC Augsburg,Bundesliga,AUT,Midfilder,"1,076,000",34,348,84,432
1240,FC Augsburg,Bundesliga,GER,Midfilder,"1,075,000",24,156,0,156
1241,VfB Stuttgart,Bundesliga,GER,Defender,"1,075,000",26,205,0,205
1242,Vigo,La Liga,ESP,Midfilder,"1,070,000",24,149,2,151
1243,Sporting CP,Primiera Liga,POR,Forward,"1,069,000",29,334,3,337
1244,Udinese,Serie A,MAR,Defender,"1,069,000",28,219,16,235
1245,Real Hispalis,La Liga,POR,Goalkeeper,"1,053,000",28,183,1,184
1246,Rennes,Ligue 1 Uber Eats,BEL,Defender,"1,052,000",22,73,3,76
1247,Parthenope,Serie A,NOR,Defender,"1,052,000",22,136,5,141
1248,Everton,Premier League,POR,Defender,"1,051,000",23,82,0,82
1249,Benfica,Primiera Liga,POR,Midfilder,"1,051,000",23,130,0,130
1250,Villarreal,La Liga,ESP,Defender,"1,050,000",30,232,4,236
1251,Villarreal,La Liga,ESP,Midfilder,"1,050,000",30,423,0,423
1252,Sampdoria,Serie A,NED,Forward,"1,048,000",25,148,0,148
1253,AS Monaco,Ligue 1 Uber Eats,MLI,Midfilder,"1,047,000",22,99,15,114
1254,Brentford,Premier League,DEN,Defender,"1,040,000",23,64,0,64
1255,Nottm Forest,Premier League,FRA,Defender,"1,040,000",22,80,0,80
1256,Man City,Premier League,GER,Goalkeeper,"1,040,000",29,266,0,266
1257,Leeds,Premier League,ITA,Forward,"1,040,000",18,65,4,69
1258,Nottm Forest,Premier League,ENG,Defender,"1,040,000",32,368,0,368
1259,Strasbourg,Ligue 1 Uber Eats,FRA,Defender,"1,040,000",27,228,0,228
1260,Aston Villa,Premier League,ENG,Goalkeeper,"1,040,000",29,120,0,120
1261,Nottm Forest,Premier League,WAL,Goalkeeper,"1,040,000",35,322,104,426
1262,Girona,La Liga,VEN,Midfilder,"1,040,000",24,171,25,196
1263,Chelsea,Premier League,USA,Goalkeeper,"1,040,000",18,43,0,43
1264,Leicester,Premier League,DEN,Goalkeeper,"1,040,000",25,151,0,151
1265,Brighton,Premier League,JPN,Midfilder,"1,040,000",25,151,7,158
1266,Leeds,Premier League,ENG,Midfilder,"1,040,000",20,13,0,13
1267,Angers SCO,Ligue 1 Uber Eats,TUN,Defender,"1,040,000",23,51,0,51
1268,AJ Auxerre,Ligue 1 Uber Eats,SCO,Midfilder,"1,040,000",25,183,0,183
1269,Capitoline,Serie A,SRB,Goalkeeper,"1,037,000",23,62,1,63
1270,Valencia,La Liga,BRA,Forward,"1,036,000",22,115,0,115
1271,Hoffenheim,Bundesliga,FRA,Defender,"1,035,000",23,85,0,85
1272,Hoffenheim,Bundesliga,USA,Defender,"1,035,000",29,284,43,327
1273,Empoli,Serie A,URU,Forward,"1,035,000",21,24,1,25
1274,Sevilla,La Liga,NED,Defender,"1,035,000",27,200,4,204
1275,FC Augsburg,Bundesliga,NED,Defender,"1,035,000",31,318,0,318
1276,Getafe,La Liga,SRB,Midfilder,"1,034,000",27,242,39,281
1277,Union Berlin,Bundesliga,GER,Defender,"1,032,000",30,325,0,325
1278,VfL Wolfsburg,Bundesliga,AUT,Goalkeeper,"1,032,000",34,266,7,273
1279,AS Monaco,Ligue 1 Uber Eats,NED,Forward,"1,032,000",21,111,1,112
1280,1. FC Koln,Bundesliga,AUT,Midfilder,"1,032,000",29,344,20,364
1281,FC Nantes,Ligue 1 Uber Eats,FRA,Midfilder,"1,032,000",30,293,0,293
1282,Bayer 04,Bundesliga,FRA,Forward,"1,032,000",22,64,0,64
1283,Schalke 04,Bundesliga,POL,Defender,"1,032,000",30,279,7,286
1284,Sevilla,La Liga,FRA,Defender,"1,032,000",22,54,0,54
1285,Strasbourg,Ligue 1 Uber Eats,FRA,Defender,"1,032,000",23,59,0,59
1286,Rennes,Ligue 1 Uber Eats,NOR,Defender,"1,032,000",27,206,22,228
1287,Mallorca,La Liga,ZIM,Forward,"1,032,000",26,162,22,184
1288,BVT,Primiera Liga,USA,Defender,"1,032,000",24,123,27,150
1289,Borussia M'gladbach,Bundesliga,GER,Defender,"1,032,000",32,257,0,257
1290,Borussia Dortmund,Bundesliga,NOR,Defender,"1,032,000",24,185,11,196
1291,Angers SCO,Ligue 1 Uber Eats,FRA,Goalkeeper,"1,031,000",25,186,0,186
1292,Eintracht Frankfurt,Bundesliga,GER,Defender,"1,031,000",28,288,3,291
1293,FC Lorient,Ligue 1 Uber Eats,GER,Goalkeeper,"1,031,000",28,140,0,140
1294,FC Lorient,Ligue 1 Uber Eats,FRA,Midfilder,"1,028,000",24,78,0,78
1295,Mallorca,La Liga,SRB,Goalkeeper,"1,022,000",26,275,28,303
1296,Real San Sebastian,La Liga,NGA,Forward,"1,017,000",25,158,7,165
1297,Sevilla,La Liga,BRA,Defender,"1,017,000",26,183,0,183
1298,A. Bilbao,La Liga,ESP,Midfilder,"1,004,000",22,85,0,85
1299,A. Bilbao,La Liga,ESP,Defender,"1,004,000",27,231,0,231
1300,AS Monaco,Ligue 1 Uber Eats,BRA,Defender,"1,003,000",21,60,0,60
1301,Espanyol,La Liga,MEX,Defender,"1,003,000",25,234,26,260
1302,Villarreal,La Liga,ALG,Defender,"998,000",30,331,76,407
1303,Spezia,Serie A,POL,Defender,"991,000",27,236,15,251
1304,Lazio,Serie A,BRA,Midfilder,"991,000",22,76,0,76
1305,Vigo,La Liga,ESP,Defender,"987,000",29,195,0,195
1306,Eintracht Frankfurt,Bundesliga,DEN,Forward,"986,000",22,92,5,97
1307,Bologna,Serie A,AUT,Defender,"986,000",25,179,16,195
1308,Cadiz,La Liga,URU,Defender,"985,000",30,247,0,247
1309,Cadiz,La Liga,ESP,Midfilder,"985,000",29,353,0,353
1310,SV Werder,Bundesliga,SRB,Defender,"983,000",26,177,20,197
1311,Strasbourg,Ligue 1 Uber Eats,FRA,Forward,"980,000",35,502,13,515
1312,RC Lens,Ligue 1 Uber Eats,FRA,Midfilder,"977,000",28,292,0,292
1313,Lazio,Serie A,ITA,Midfilder,"977,000",20,12,1,13
1314,Vigo,La Liga,ESP,Defender,"976,000",23,79,1,80
1315,OGC Nice,Ligue 1 Uber Eats,NGA,Forward,"973,000",23,133,7,140
1316,Real San Sebastian,La Liga,ESP,Defender,"966,000",25,203,0,203
1317,Getafe,La Liga,ESP,Midfilder,"966,000",30,412,0,412
1318,Brianza,Serie A,DEN,Forward,"966,000",32,362,9,371
1319,Benfica,Primiera Liga,NOR,Forward,"964,000",18,55,0,55
1320,Sevilla,La Liga,ESP,Forward,"963,000",25,181,0,181
1321,Sevilla,La Liga,SRB,Goalkeeper,"963,000",30,234,19,253
1322,Sevilla,La Liga,ESP,Midfilder,"963,000",28,287,0,287
1323,Sevilla,La Liga,ESP,Midfilder,"963,000",28,253,5,258
1324,Cremonese,Serie A,ITA,Defender,"957,000",25,108,0,108
1325,Empoli,Serie A,ITA,Goalkeeper,"957,000",25,188,0,188
1326,Fiorentina,Serie A,ITA,Defender,"957,000",23,97,0,97
1327,Fiorentina,Serie A,ITA,Midfilder,"957,000",23,79,0,79
1328,Spezia,Serie A,MAR,Midfilder,"957,000",31,186,8,194
1329,Sampdoria,Serie A,NED,Defender,"957,000",32,314,0,314
1330,Atalanta,Serie A,ITA,Goalkeeper,"957,000",30,276,0,276
1331,Sassuolo,Serie A,ITA,Defender,"957,000",30,363,1,364
1332,Verona,Serie A,SRB,Defender,"957,000",31,370,23,393
1333,Empoli,Serie A,ITA,Midfilder,"957,000",27,192,0,192
1334,Verona,Serie A,ITA,Defender,"957,000",26,152,0,152
1335,A. Bilbao,La Liga,ESP,Midfilder,"953,000",32,430,0,430
1336,AC Ajaccio,Ligue 1 Uber Eats,ALG,Midfilder,"950,000",30,179,43,222
1337,OM,Ligue 1 Uber Eats,BIH,Defender,"948,000",29,218,49,267
1338,FC Augsburg,Bundesliga,CZE,Goalkeeper,"948,000",30,216,11,227
1339,Vallecano,La Liga,ESP,Midfilder,"947,000",29,353,0,353
1340,Verona,Serie A,ARG,Forward,"946,000",23,84,1,85
1341,Espanyol,La Liga,FRA,Defender,"946,000",24,106,0,106
1342,Villarreal,La Liga,ESP,Defender,"945,000",31,379,0,379
1343,Villarreal,La Liga,ESP,Midfilder,"945,000",21,76,0,76
1344,Salernitana,Serie A,SEN,Forward,"945,000",25,129,17,146
1345,Salernitana,Serie A,NED,Midfilder,"941,000",27,287,15,302
1346,Sassuolo,Serie A,EQG,Midfilder,"940,000",30,280,11,291
1347,FC Porto,Primiera Liga,ESP,Forward,"929,000",25,138,0,138
1348,Strasbourg,Ligue 1 Uber Eats,SEN,Forward,"929,000",27,220,14,234
1349,Real Hispalis,La Liga,SEN,Defender,"928,000",29,238,24,262
1350,FC Nantes,Ligue 1 Uber Eats,BRA,Defender,"928,000",30,281,0,281
1351,Strasbourg,Ligue 1 Uber Eats,BEL,Goalkeeper,"928,000",30,278,2,280
1352,Angers SCO,Ligue 1 Uber Eats,FRA,Forward,"928,000",29,231,0,231
1353,Espanyol,La Liga,ESP,Goalkeeper,"923,000",30,335,0,335
1354,Espanyol,La Liga,DEN,Forward,"923,000",31,363,60,423
1355,Vigo,La Liga,ARG,Goalkeeper,"923,000",34,420,8,428
1356,Real Hispalis,La Liga,ESP,Defender,"921,000",26,202,0,202
1357,FC Porto,Primiera Liga,BRA,Forward,"920,000",20,49,0,49
1358,Udinese,Serie A,NGA,Defender,"917,000",27,192,0,192
1359,Udinese,Serie A,CMR,Defender,"917,000",23,53,0,53
1360,Brianza,Serie A,ITA,Defender,"914,000",32,220,0,220
1361,Brentford,Premier League,WAL,Defender,"910,000",19,22,0,22
1362,Sevilla,La Liga,ARG,Defender,"910,000",25,92,16,108
1363,Benfica,Primiera Liga,DEN,Defender,"908,000",24,185,3,188
1364,Getafe,La Liga,TUR,Forward,"903,000",25,257,27,284
1365,Getafe,La Liga,ESP,Goalkeeper,"903,000",29,230,0,230
1366,A. Bilbao,La Liga,ESP,Defender,"903,000",23,151,0,151
1367,A. Bilbao,La Liga,ESP,Midfilder,"903,000",29,268,0,268
1368,Sassuolo,Serie A,ITA,Defender,"902,000",23,86,0,86
1369,Montpellier,Ligue 1 Uber Eats,FRA,Goalkeeper,"898,000",31,291,0,291
1370,Atalanta,Serie A,ITA,Defender,"897,000",21,43,0,43
1371,RC Lens,Ligue 1 Uber Eats,FRA,Goalkeeper,"897,000",28,177,0,177
1372,Union Berlin,Bundesliga,NOR,Midfilder,"897,000",26,226,9,235
1373,Estoril Praia,Primiera Liga,POR,Forward,"897,000",25,221,0,221
1374,FC Augsburg,Bundesliga,GER,Midfilder,"897,000",23,117,0,117
1375,OGC Nice,Ligue 1 Uber Eats,FRA,Midfilder,"897,000",22,92,0,92
1376,Union Berlin,Bundesliga,GER,Defender,"897,000",26,186,0,186
1377,Villarreal,La Liga,ESP,Defender,"893,000",22,139,0,139
1378,Villarreal,La Liga,SEN,Forward,"893,000",21,55,0,55
1379,Milan,Serie A,GER,Defender,"888,000",21,60,0,60
1380,Milan,Serie A,FRA,Midfilder,"888,000",22,101,0,101
1381,Cremonese,Serie A,SUI,Midfilder,"885,000",25,199,0,199
1382,Brianza,Serie A,ITA,Defender,"885,000",23,175,0,175
1383,Cremonese,Serie A,NGA,Forward,"885,000",25,159,0,159
1384,Salento,Serie A,ITA,Forward,"885,000",28,228,0,228
1385,Hertha Berlin,Bundesliga,CRO,Midfilder,"884,000",25,228,1,229
1386,RC Lens,Ligue 1 Uber Eats,ARG,Defender,"883,000",23,94,2,96
1387,Eintracht Frankfurt,Bundesliga,JPN,Defender,"881,000",38,513,114,627
1388,Cadiz,La Liga,ESP,Forward,"881,000",31,332,0,332
1389,Cadiz,La Liga,COD,Midfilder,"881,000",26,239,3,242
1390,Hertha Berlin,Bundesliga,CIV,Forward,"878,000",24,107,0,107
1391,Empoli,Serie A,ITA,Forward,"877,000",31,289,8,297
1392,FC Porto,Primiera Liga,POR,Defender,"876,000",23,83,0,83
1393,FC Nantes,Ligue 1 Uber Eats,FRA,Goalkeeper,"876,000",23,242,0,242
1394,Sporting CP,Primiera Liga,URU,Midfilder,"875,000",21,103,5,108
1395,A. Madrid,La Liga,CRO,Goalkeeper,"872,000",26,150,2,152
1396,SC Freiburg,Bundesliga,ITA,Midfilder,"862,000",29,278,6,284
1397,Bologna,Serie A,ITA,Defender,"862,000",22,104,0,104
1398,Borussia Dortmund,Bundesliga,GER,Defender,"862,000",24,74,0,74
1399,Hertha Berlin,Bundesliga,GER,Defender,"862,000",27,205,0,205
1400,FC Augsburg,Bundesliga,BRA,Defender,"862,000",25,104,0,104
1401,Union Berlin,Bundesliga,DEN,Goalkeeper,"862,000",30,208,8,216
1402,VfL Bochum,Bundesliga,UKR,Defender,"862,000",30,190,12,202
1403,Union Berlin,Bundesliga,FRA,Defender,"860,000",29,248,0,248
1404,VfL Wolfsburg,Bundesliga,USA,Defender,"860,000",19,48,0,48
1405,Mainz 05,Bundesliga,NOR,Defender,"860,000",25,193,12,205
1406,Union Berlin,Bundesliga,AUT,Defender,"860,000",35,421,23,444
1407,Bayer 04,Bundesliga,RUS,Goalkeeper,"860,000",30,152,7,159
1408,Union Berlin,Bundesliga,GER,Midfilder,"860,000",28,271,0,271
1409,Schalke 04,Bundesliga,GER,Midfilder,"860,000",21,70,0,70
1410,Mainz 05,Bundesliga,GER,Defender,"860,000",24,92,0,92
1411,Verona,Serie A,NED,Defender,"860,000",24,148,0,148
1412,Schalke 04,Bundesliga,NED,Defender,"860,000",25,138,0,138
1413,Union Berlin,Bundesliga,GER,Forward,"860,000",21,82,0,82
1414,Schalke 04,Bundesliga,AUT,Defender,"860,000",21,78,0,78
1415,Schalke 04,Bundesliga,SUI,Defender,"860,000",28,249,0,249
1416,AS Monaco,Ligue 1 Uber Eats,BRA,Midfilder,"859,000",24,102,0,102
1417,1. FC Koln,Bundesliga,GHA,Midfilder,"859,000",29,247,0,247
1418,Borussia Dortmund,Bundesliga,ESP,Defender,"859,000",22,21,0,21
1419,Hoffenheim,Bundesliga,NGA,Defender,"859,000",27,216,4,220
1420,Verona,Serie A,SVK,Midfilder,"859,000",27,238,59,297
1421,SC Freiburg,Bundesliga,AUT,Forward,"859,000",28,355,39,394
1422,Benfica,Primiera Liga,BRA,Defender,"858,000",21,62,0,62
1423,Getafe,La Liga,TOG,Defender,"858,000",30,263,67,330
1424,Getafe,La Liga,URU,Midfilder,"858,000",26,218,12,230
1425,A. Bilbao,La Liga,ESP,Defender,"853,000",30,318,0,318
1426,Atletico Pamplona,La Liga,ESP,Midfilder,"845,000",29,335,0,335
1427,Benfica,Primiera Liga,BRA,Defender,"839,000",29,182,0,182
1428,Benfica,Primiera Liga,SRB,Defender,"832,000",26,181,9,190
1429,Brighton,Premier League,ENG,Goalkeeper,"832,000",32,272,0,272
1430,Espanyol,La Liga,ESP,Defender,"831,000",30,291,0,291
1431,Sporting CP,Primiera Liga,POR,Defender,"830,000",21,53,0,53
1432,Cadiz,La Liga,ESP,Forward,"830,000",37,593,21,614
1433,Cadiz,La Liga,HON,Forward,"830,000",29,354,40,394
1434,Valladolid,La Liga,ESP,Forward,"830,000",33,356,0,356
1435,Elche,La Liga,ESP,Defender,"830,000",30,328,0,328
1436,FC Augsburg,Bundesliga,GER,Midfilder,"829,000",24,187,0,187
1437,Benfica,Primiera Liga,DEN,Forward,"829,000",22,77,0,77
1438,Sassuolo,Serie A,URU,Forward,"828,000",21,67,4,71
1439,Benfica,Primiera Liga,CRO,Forward,"827,000",24,149,0,149
1440,Reims,Ligue 1 Uber Eats,MAR,Defender,"825,000",34,319,10,329
1441,FC Nantes,Ligue 1 Uber Eats,FRA,Midfilder,"825,000",24,211,0,211
1442,Strasbourg,Ligue 1 Uber Eats,CIV,Midfilder,"825,000",28,196,2,198
1443,Real Hispalis,La Liga,MEX,Midfilder,"824,000",35,475,175,650
1444,Inter,Serie A,ITA,Defender,"818,000",22,63,0,63
1445,FC Porto,Primiera Liga,CAN,Midfilder,"818,000",25,202,24,226
1446,Schalke 04,Bundesliga,FIN,Defender,"817,000",28,256,60,316
1447,VfL Wolfsburg,Bundesliga,GER,Defender,"817,000",21,75,0,75
1448,RC Lens,Ligue 1 Uber Eats,POR,Forward,"815,000",21,46,0,46
1449,RC Lens,Ligue 1 Uber Eats,GHA,Midfilder,"815,000",22,48,0,48
1450,Getafe,La Liga,POR,Defender,"813,000",27,242,3,245
1451,Valladolid,La Liga,MAR,Midfilder,"807,000",25,159,22,181
1452,Salernitana,Serie A,NOR,Midfilder,"807,000",23,139,0,139
1453,A. Bilbao,La Liga,ESP,Defender,"803,000",29,233,0,233
1454,Torino,Serie A,ENG,Midfilder,"802,000",24,125,0,125
1455,Sassuolo,Serie A,ITA,Goalkeeper,"802,000",41,361,0,361
1456,Sampdoria,Serie A,ITA,Forward,"802,000",39,625,28,653
1457,Udinese,Serie A,ITA,Goalkeeper,"802,000",31,289,0,289
1458,Bournemouth,Premier League,CIV,Midfilder,"802,000",22,139,4,143
1459,Sassuolo,Serie A,ITA,Defender,"802,000",24,102,0,102
1460,Verona,Serie A,ITA,Defender,"802,000",30,316,0,316
1461,Verona,Serie A,ITA,Defender,"802,000",30,286,0,286
1462,Spezia,Serie A,POL,Midfilder,"802,000",24,163,5,168
1463,Verona,Serie A,POR,Midfilder,"802,000",36,400,56,456
1464,Estoril Praia,Primiera Liga,BRA,Forward,"802,000",25,188,0,188
1465,FC Porto,Primiera Liga,BRA,Midfilder,"800,000",24,191,0,191
1466,Hertha Berlin,Bundesliga,URU,Defender,"798,000",24,94,1,95
1467,Bologna,Serie A,GRE,Defender,"797,000",28,222,6,228
1468,Empoli,Serie A,CIV,Midfilder,"797,000",29,226,16,242
1469,Fiorentina,Serie A,CZE,Midfilder,"797,000",27,203,31,234
1470,Salernitana,Serie A,ITA,Forward,"797,000",25,168,0,168
1471,Almeria,La Liga,ESP,Defender,"797,000",23,192,1,193
1472,Spezia,Serie A,ITA,Midfilder,"793,000",21,117,0,117
1473,Sporting CP,Primiera Liga,JPN,Midfilder,"791,000",27,203,15,218
1474,Villarreal,La Liga,ESP,Goalkeeper,"787,000",40,677,36,713
1475,Mallorca,La Liga,ESP,Midfilder,"787,000",23,192,0,192
1476,Reims,Ligue 1 Uber Eats,BEL,Defender,"786,000",22,91,0,91
1477,Vallecano,La Liga,ARG,Midfilder,"785,000",34,482,0,482
1478,Vallecano,La Liga,ESP,Midfilder,"785,000",27,290,0,290
1479,Hertha Berlin,Bundesliga,ENG,Defender,"785,000",25,121,0,121
1480,Benfica,Primiera Liga,POR,Forward,"785,000",21,79,0,79
1481,Eintracht Frankfurt,Bundesliga,CRO,Midfilder,"785,000",25,164,4,168
1482,Hertha Berlin,Bundesliga,NED,Midfilder,"785,000",28,263,1,264
1483,Chelsea,Premier League,ENG,Midfilder,"780,000",18,0,0,0
1484,Nottm Forest,Premier League,IRL,Midfilder,"780,000",32,358,19,377
1485,Chelsea,Premier League,ENG,Midfilder,"780,000",22,114,4,118
1486,Wolves,Premier League,ENG,Goalkeeper,"780,000",29,404,0,404
1487,Brighton,Premier League,PAR,Forward,"780,000",18,59,5,64
1488,Chelsea,Premier League,ENG,Midfilder,"780,000",18,0,0,0
1489,Nottm Forest,Premier League,MSR,Forward,"780,000",32,472,13,485
1490,Brighton,Premier League,ENG,Defender,"780,000",19,32,0,32
1491,Nottm Forest,Premier League,ENG,Forward,"780,000",24,167,0,167
1492,Fulham,Premier League,SVK,Goalkeeper,"780,000",25,192,17,209
1493,Santa Clara,Primiera Liga,POR,Midfilder,"780,000",23,77,0,77
1494,Leeds,Premier League,NOR,Goalkeeper,"780,000",21,99,0,99
1495,Liverpool,Premier League,SCO,Defender,"780,000",19,28,0,28
1496,FC Lorient,Ligue 1 Uber Eats,FRA,Midfilder,"778,000",29,239,0,239
1497,Torino,Serie A,KOS,Defender,"776,000",27,212,45,257
1498,Fiorentina,Serie A,BRA,Defender,"776,000",24,143,0,143
1499,Bologna,Serie A,ARG,Midfilder,"776,000",24,152,11,163
1500,Capitoline,Serie A,FRA,Defender,"776,000",22,36,0,36
1501,Bologna,Serie A,ITA,Goalkeeper,"776,000",30,256,0,256
1502,Sassuolo,Serie A,GER,Defender,"776,000",28,184,0,184
1503,Real Hispalis,La Liga,BRA,Forward,"776,000",21,77,0,77
1504,Elche,La Liga,ESP,Midfilder,"776,000",23,101,0,101
1505,Atletico Pamplona,La Liga,MAR,Midfilder,"776,000",20,90,0,90
1506,Vigo,La Liga,ESP,Goalkeeper,"774,000",25,120,0,120
1507,OL,Ligue 1 Uber Eats,CIV,Defender,"774,000",21,44,9,53
1508,Schalke 04,Bundesliga,GER,Defender,"774,000",27,234,0,234
1509,AS Monaco,Ligue 1 Uber Eats,FRA,Defender,"774,000",24,117,0,117
1510,Union Berlin,Bundesliga,GER,Midfilder,"774,000",28,276,0,276
1511,VfB Stuttgart,Bundesliga,GER,Defender,"774,000",26,167,0,167
1512,AS Monaco,Ligue 1 Uber Eats,SEN,Defender,"772,000",23,104,0,104
1513,Salernitana,Serie A,NOR,Forward,"770,000",22,124,0,124
1514,Salento,Serie A,ESP,Midfilder,"770,000",20,3,0,3
1515,Salernitana,Serie A,TUN,Defender,"770,000",27,218,35,253
1516,Brianza,Serie A,ITA,Midfilder,"767,000",28,317,0,317
1517,Valencia,La Liga,ESP,Midfilder,"762,000",27,286,0,286
1518,Sporting CP,Primiera Liga,POR,Defender,"756,000",29,270,0,270
1519,Atletico Pamplona,La Liga,ESP,Midfilder,"756,000",28,343,0,343
1520,Sporting CP,Primiera Liga,BRA,Midfilder,"755,000",27,123,0,123
1521,FC Augsburg,Bundesliga,ENG,Defender,"752,000",23,94,0,94
1522,VfL Bochum,Bundesliga,GER,Goalkeeper,"752,000",33,433,0,433
1523,SC Freiburg,Bundesliga,GER,Defender,"752,000",29,319,6,325
1524,Sporting CP,Primiera Liga,POR,Forward,"751,000",27,158,0,158
1525,Borussia M'gladbach,Bundesliga,USA,Defender,"748,000",19,55,2,57
1526,RC Lens,Ligue 1 Uber Eats,FRA,Defender,"747,000",29,270,0,270
1527,VfL Bochum,Bundesliga,CMR,Midfilder,"742,000",27,236,29,265
1528,Vallecano,La Liga,ESP,Defender,"741,000",27,291,0,291
1529,Sporting CP,Primiera Liga,POR,Defender,"740,000",27,203,0,203
1530,Espanyol,La Liga,ESP,Defender,"738,000",33,343,1,344
1531,LOSC,Ligue 1 Uber Eats,KOS,Midfilder,"736,000",23,101,28,129
1532,Villarreal,La Liga,COL,Defender,"735,000",30,271,21,292
1533,BRG,Primiera Liga,FRA,Defender,"733,000",23,114,0,114
1534,Schalke 04,Bundesliga,GER,Defender,"731,000",21,40,0,40
1535,Mainz 05,Bundesliga,GER,Midfilder,"731,000",23,127,2,129
1536,Schalke 04,Bundesliga,GER,Defender,"731,000",23,50,0,50
1537,Borussia M'gladbach,Bundesliga,GER,Goalkeeper,"731,000",34,235,0,235
1538,Mainz 05,Bundesliga,GER,Defender,"731,000",29,206,0,206
1539,Schalke 04,Bundesliga,TUR,Forward,"731,000",28,218,31,249
1540,VfB Stuttgart,Bundesliga,POR,Defender,"729,000",25,176,0,176
1541,Real Hispalis,La Liga,ESP,Defender,"727,000",33,349,0,349
1542,Cadiz,La Liga,ESP,Defender,"726,000",32,299,0,299
1543,Cadiz,La Liga,ARG,Goalkeeper,"726,000",29,141,0,141
1544,Capitoline,Serie A,POL,Defender,"726,000",20,20,5,25
1545,VfB Stuttgart,Bundesliga,JPN,Defender,"723,000",23,95,3,98
1546,Cadiz,La Liga,ESP,Midfilder,"722,000",25,230,0,230
1547,Cadiz,La Liga,ESP,Defender,"722,000",30,253,0,253
1548,Rennes,Ligue 1 Uber Eats,FRA,Goalkeeper,"722,000",38,227,0,227
1549,Strasbourg,Ligue 1 Uber Eats,GHA,Defender,"722,000",28,195,17,212
1550,Strasbourg,Ligue 1 Uber Eats,BIH,Midfilder,"721,000",28,183,14,197
1551,Salento,Serie A,ITA,Defender,"718,000",24,115,0,115
1552,Reims,Ligue 1 Uber Eats,JPN,Midfilder,"717,000",29,257,36,293
1553,Brianza,Serie A,ITA,Goalkeeper,"716,000",25,162,0,162
1554,Parthenope,Serie A,POL,Defender,"716,000",30,282,43,325
1555,Empoli,Serie A,ITA,Forward,"713,000",19,5,0,5
1556,Cremonese,Serie A,GEO,Defender,"713,000",24,119,0,119
1557,Salernitana,Serie A,FRA,Defender,"713,000",25,221,0,221
1558,FC Augsburg,Bundesliga,FRA,Forward,"713,000",25,139,0,139
1559,Atletico Pamplona,La Liga,ESP,Defender,"712,000",28,269,0,269
1560,Atletico Pamplona,La Liga,ESP,Defender,"712,000",33,350,0,350
1561,Atletico Pamplona,La Liga,ESP,Midfilder,"712,000",24,170,0,170
1562,Real San Sebastian,La Liga,ESP,Defender,"712,000",29,271,0,271
1563,Real San Sebastian,La Liga,ESP,Defender,"712,000",26,177,0,177
1564,Cremonese,Serie A,MEX,Defender,"704,000",23,158,6,164
1565,OL,Ligue 1 Uber Eats,FRA,Midfilder,"702,000",19,59,0,59
1566,OM,Ligue 1 Uber Eats,MAR,Midfilder,"702,000",22,74,7,81
1567,A. Bilbao,La Liga,ESP,Defender,"702,000",34,393,0,393
1568,Hertha Berlin,Bundesliga,CRO,Defender,"699,000",25,174,6,180
1569,AC Ajaccio,Ligue 1 Uber Eats,FRA,Midfilder,"697,000",35,477,0,477
1570,LOSC,Ligue 1 Uber Eats,FRA,Midfilder,"695,000",32,267,0,267
1571,Sporting CP,Primiera Liga,GRE,Midfilder,"695,000",20,68,5,73
1572,Espanyol,La Liga,ESP,Forward,"692,000",32,393,0,393
1573,SC Freiburg,Bundesliga,FRA,Defender,"690,000",32,363,0,363
1574,OGC Nice,Ligue 1 Uber Eats,FRA,Defender,"688,000",21,54,0,54
1575,Schalke 04,Bundesliga,GER,Midfilder,"688,000",25,145,0,145
1576,VfB Stuttgart,Bundesliga,JPN,Midfilder,"688,000",31,406,73,479
1577,Union Berlin,Bundesliga,GER,Midfilder,"688,000",32,323,0,323
1578,Mainz 05,Bundesliga,NED,Forward,"688,000",23,96,0,96
1579,Schalke 04,Bundesliga,FRA,Defender,"688,000",30,269,0,269
1580,Valencia,La Liga,GUI,Defender,"687,000",25,137,0,137
1581,VfL Bochum,Bundesliga,GER,Defender,"687,000",29,270,0,270
1582,Union Berlin,Bundesliga,GER,Goalkeeper,"687,000",23,84,0,84
1583,Sampdoria,Serie A,ESP,Forward,"684,000",29,280,0,280
1584,Real Hispalis,La Liga,ESP,Midfilder,"679,000",22,103,0,103
1585,Real Hispalis,La Liga,ESP,Defender,"679,000",25,152,0,152
1586,Strasbourg,Ligue 1 Uber Eats,FRA,Midfilder,"674,000",24,157,0,157
1587,FC Augsburg,Bundesliga,POL,Goalkeeper,"672,000",34,291,0,291
1588,Troyes,Ligue 1 Uber Eats,CRO,Midfilder,"672,000",22,107,0,107
1589,Angers SCO,Ligue 1 Uber Eats,ALG,Defender,"672,000",31,247,37,284
1590,Eintracht Frankfurt,Bundesliga,USA,Defender,"672,000",32,315,29,344
1591,Sassuolo,Serie A,NOR,Midfilder,"672,000",23,149,17,166
1592,Valencia,La Liga,BRA,Forward,"672,000",25,180,0,180
1593,RC Lens,Ligue 1 Uber Eats,AUT,Defender,"672,000",23,123,10,133
1594,Angers SCO,Ligue 1 Uber Eats,ALG,Midfilder,"672,000",27,166,35,201
1595,AS Monaco,Ligue 1 Uber Eats,FRA,Goalkeeper,"672,000",26,206,0,206
1596,Hertha Berlin,Bundesliga,SVK,Defender,"672,000",35,429,112,541
1597,Hoffenheim,Bundesliga,GER,Midfilder,"672,000",21,81,0,81
1598,Hertha Berlin,Bundesliga,GER,Midfilder,"672,000",24,193,0,193
1599,Montpellier,Ligue 1 Uber Eats,FRA,Defender,"672,000",29,248,0,248
1600,VfB Stuttgart,Bundesliga,FRA,Defender,"672,000",23,71,0,71
1601,Montpellier,Ligue 1 Uber Eats,GUI,Defender,"672,000",28,248,68,316
1602,SC Freiburg,Bundesliga,JPN,Midfilder,"672,000",24,174,26,200
1603,Rennes,Ligue 1 Uber Eats,FRA,Midfilder,"672,000",27,297,0,297
1604,RC Lens,Ligue 1 Uber Eats,BEL,Forward,"672,000",22,107,3,110
1605,1. FC Koln,Bundesliga,DEN,Defender,"672,000",28,327,1,328
1606,Union Berlin,Bundesliga,TUN,Midfilder,"672,000",25,157,22,179
1607,Rennes,Ligue 1 Uber Eats,BEL,Forward,"672,000",20,82,10,92
1608,Elche,La Liga,ARG,Defender,"672,000",28,179,0,179
1609,Montpellier,Ligue 1 Uber Eats,POR,Defender,"670,000",31,280,1,281
1610,Rennes,Ligue 1 Uber Eats,POR,Midfilder,"668,000",27,205,0,205
1611,Atletico Pamplona,La Liga,ARG,Forward,"667,000",28,218,0,218
1612,Udinese,Serie A,BRA,Defender,"664,000",26,146,0,146
1613,Sassuolo,Serie A,FRA,Midfilder,"664,000",24,182,0,182
1614,Atalanta,Serie A,FRA,Defender,"664,000",20,38,0,38
1615,Brianza,Serie A,BUL,Defender,"664,000",21,78,11,89
1616,Udinese,Serie A,GER,Midfilder,"664,000",32,303,0,303
1617,Salernitana,Serie A,MLI,Midfilder,"664,000",26,164,29,193
1618,Hertha Berlin,Bundesliga,NOR,Goalkeeper,"663,000",37,399,72,471
1619,Espanyol,La Liga,ESP,Goalkeeper,"662,000",24,130,1,131
1620,FC Porto,Primiera Liga,POR,Defender,"661,000",22,90,0,90
1621,Real San Sebastian,La Liga,ESP,Forward,"661,000",26,208,0,208
1622,Sporting CP,Primiera Liga,BRA,Defender,"660,000",27,155,0,155
1623,Salernitana,Serie A,NGA,Defender,"658,000",29,226,62,288
1624,Almeria,La Liga,ARG,Midfilder,"657,000",25,117,0,117
1625,Almeria,La Liga,ESP,Midfilder,"657,000",30,277,0,277
1626,Salento,Serie A,ZAM,Forward,"655,000",21,73,4,77
1627,Salento,Serie A,GAM,Forward,"655,000",28,180,32,212
1628,Cremonese,Serie A,ITA,Forward,"655,000",37,543,0,543
1629,Sassuolo,Serie A,NOR,Forward,"655,000",21,110,0,110
1630,Elche,La Liga,ESP,Goalkeeper,"654,000",30,342,0,342
1631,Vallecano,La Liga,COL,Forward,"654,000",36,419,102,521
1632,Valladolid,La Liga,ESP,Goalkeeper,"654,000",33,340,1,341
1633,Vallecano,La Liga,ESP,Midfilder,"654,000",25,207,0,207
1634,Vallecano,La Liga,ESP,Goalkeeper,"654,000",40,559,1,560
1635,Rennes,Ligue 1 Uber Eats,MLI,Defender,"653,000",30,292,42,334
1636,Sporting CP,Primiera Liga,CIV,Defender,"650,000",18,0,0,0
1637,SC Freiburg,Bundesliga,GER,Midfilder,"650,000",25,250,0,250
1638,OGC Nice,Ligue 1 Uber Eats,ALG,Midfilder,"649,000",22,106,10,116
1639,FC Lorient,Ligue 1 Uber Eats,FRA,Midfilder,"649,000",22,106,0,106
1640,Espanyol,La Liga,URU,Defender,"646,000",31,398,0,398
1641,OM,Ligue 1 Uber Eats,ESP,Goalkeeper,"646,000",27,180,0,180
1642,VfL Wolfsburg,Bundesliga,GER,Midfilder,"645,000",21,21,0,21
1643,Brianza,Serie A,ITA,Forward,"645,000",29,302,1,303
1644,Brest,Ligue 1 Uber Eats,NED,Goalkeeper,"645,000",31,290,1,291
1645,Union Berlin,Bundesliga,GER,Midfilder,"645,000",29,262,0,262
1646,VfB Stuttgart,Bundesliga,GER,Midfilder,"645,000",24,155,0,155
1647,1. FC Koln,Bundesliga,GER,Midfilder,"645,000",20,74,0,74
1648,Borussia M'gladbach,Bundesliga,GER,Goalkeeper,"645,000",20,47,0,47
1649,SV Werder,Bundesliga,GER,Defender,"645,000",33,385,0,385
1650,FC Augsburg,Bundesliga,GER,Defender,"645,000",24,125,0,125
1651,SC Freiburg,Bundesliga,HUN,Midfilder,"645,000",25,194,36,230
1652,Schalke 04,Bundesliga,SUI,Forward,"645,000",28,305,0,305
1653,VfL Wolfsburg,Bundesliga,NED,Defender,"645,000",21,64,0,64
1654,Clermont,Ligue 1 Uber Eats,GHA,Defender,"643,000",22,49,2,51
1655,RC Lens,Ligue 1 Uber Eats,POL,Forward,"642,000",26,180,9,189
1656,RC Lens,Ligue 1 Uber Eats,FRA,Defender,"642,000",28,231,0,231
1657,Torino,Serie A,CZE,Defender,"638,000",21,58,11,69
1658,Fiorentina,Serie A,ITA,Defender,"638,000",27,200,0,200
1659,Spezia,Serie A,ITA,Goalkeeper,"638,000",39,358,11,369
1660,Bologna,Serie A,SCO,Midfilder,"638,000",23,150,4,154
1661,Brianza,Serie A,ITA,Defender,"638,000",31,338,0,338
1662,Cremonese,Serie A,ITA,Defender,"638,000",28,131,0,131
1663,Spezia,Serie A,ANG,Forward,"638,000",26,183,5,188
1664,Salernitana,Serie A,ITA,Defender,"638,000",22,64,0,64
1665,Spezia,Serie A,ITA,Defender,"638,000",30,175,0,175
1666,Spezia,Serie A,ITA,Forward,"638,000",26,188,0,188
1667,Parthenope,Serie A,ITA,Midfilder,"638,000",22,86,0,86
1668,Sassuolo,Serie A,ITA,Defender,"638,000",25,77,0,77
1669,Torino,Serie A,SRB,Goalkeeper,"638,000",25,94,4,98
1670,Spezia,Serie A,COL,Midfilder,"638,000",23,109,0,109
1671,Capitoline,Serie A,GUI,Midfilder,"636,000",25,163,21,184
1672,Capitoline,Serie A,GAM,Midfilder,"636,000",21,6,13,19
1673,Cadiz,La Liga,ESP,Defender,"636,000",25,205,0,205
1674,Getafe,La Liga,ESP,Midfilder,"632,000",27,245,0,245
1675,Getafe,La Liga,ESP,Forward,"632,000",25,197,0,197
1676,Toulouse FC,Ligue 1 Uber Eats,BEL,Midfilder,"628,000",31,323,0,323
1677,Liverpool,Premier League,ENG,Defender,"624,000",21,40,0,40
1678,Brighton,Premier League,ECU,Forward,"624,000",20,5,12,17
1679,Schalke 04,Bundesliga,NED,Defender,"624,000",20,88,0,88
1680,FC Lorient,Ligue 1 Uber Eats,SUI,Goalkeeper,"621,000",28,225,4,229
1681,Eintracht Frankfurt,Bundesliga,FRA,Defender,"620,000",21,69,0,69
1682,Montpellier,Ligue 1 Uber Eats,MLI,Defender,"619,000",25,160,21,181
1683,Reims,Ligue 1 Uber Eats,BEL,Defender,"619,000",27,350,10,360
1684,LOSC,Ligue 1 Uber Eats,USA,Forward,"619,000",22,75,25,100
1685,Angers SCO,Ligue 1 Uber Eats,CIV,Defender,"619,000",25,128,4,132
1686,Strasbourg,Ligue 1 Uber Eats,RSA,Forward,"619,000",26,117,14,131
1687,FC Porto,Primiera Liga,POR,Midfilder,"616,000",24,60,0,60
1688,Spezia,Serie A,FRA,Defender,"612,000",24,175,0,175
1689,OGC Nice,Ligue 1 Uber Eats,BDI,Defender,"608,000",23,85,17,102
1690,1. FC Koln,Bundesliga,GER,Goalkeeper,"605,000",27,272,0,272
1691,Sporting CP,Primiera Liga,CPV,Forward,"605,000",24,108,5,113
1692,VfB Stuttgart,Bundesliga,CRO,Defender,"603,000",24,127,6,133
1693,Parthenope,Serie A,ITA,Forward,"602,000",22,77,13,90
1694,Vigo,La Liga,ESP,Defender,"602,000",25,137,1,138
1695,Reims,Ligue 1 Uber Eats,KOS,Forward,"598,000",27,193,29,222
1696,Salernitana,Serie A,CYP,Midfilder,"598,000",24,125,47,172
1697,SV Werder,Bundesliga,GER,Defender,"597,000",30,331,0,331
1698,1. FC Koln,Bundesliga,GER,Defender,"590,000",24,104,0,104
1699,BRG,Primiera Liga,SRB,Midfilder,"583,000",24,159,8,167
1700,SV Werder,Bundesliga,GER,Defender,"583,000",22,92,0,92
1701,Toulouse FC,Ligue 1 Uber Eats,NED,Midfilder,"581,000",27,261,0,261
1702,Atletico Pamplona,La Liga,ESP,Defender,"578,000",31,327,0,327
1703,Barcelona,La Liga,ESP,Goalkeeper,"576,000",23,65,0,65
1704,Valencia,La Liga,ESP,Midfilder,"576,000",20,56,0,56
1705,LOSC,Ligue 1 Uber Eats,GUI,Forward,"572,000",24,115,21,136
1706,Sporting CP,Primiera Liga,BRA,Forward,"572,000",24,122,0,122
1707,VfB Stuttgart,Bundesliga,COD,Midfilder,"572,000",23,109,0,109
1708,AJ Auxerre,Ligue 1 Uber Eats,ALG,Defender,"572,000",27,173,1,174
1709,Clermont,Ligue 1 Uber Eats,SEN,Goalkeeper,"572,000",29,106,0,106
1710,Clermont,Ligue 1 Uber Eats,FRA,Midfilder,"572,000",33,342,8,350
1711,OL,Ligue 1 Uber Eats,SWE,Forward,"570,000",21,71,0,71
1712,Milan,Serie A,COL,Goalkeeper,"568,000",24,28,0,28
1713,OGC Nice,Ligue 1 Uber Eats,SUI,Defender,"568,000",23,168,7,175
1714,1. FC Koln,Bundesliga,GER,Defender,"567,000",27,199,0,199
1715,Troyes,Ligue 1 Uber Eats,FRA,Midfilder,"567,000",29,292,0,292
1716,RC Lens,Ligue 1 Uber Eats,FRA,Goalkeeper,"567,000",36,275,0,275
1717,RC Lens,Ligue 1 Uber Eats,FRA,Forward,"567,000",27,177,0,177
1718,Elche,La Liga,ESP,Defender,"567,000",32,316,0,316
1719,Mallorca,La Liga,URU,Defender,"567,000",27,179,16,195
1720,Vallecano,La Liga,MKD,Goalkeeper,"567,000",28,321,56,377
1721,Vallecano,La Liga,ALB,Defender,"567,000",30,317,6,323
1722,Elche,La Liga,ESP,Midfilder,"567,000",32,450,0,450
1723,Empoli,Serie A,ITA,Forward,"566,000",21,54,0,54
1724,Hertha Berlin,Bundesliga,TUR,Midfilder,"561,000",30,220,3,223
1725,VfL Bochum,Bundesliga,AUT,Midfilder,"560,000",29,244,0,244
1726,Union Berlin,Bundesliga,GER,Forward,"560,000",31,328,0,328
1727,Union Berlin,Bundesliga,GER,Midfilder,"560,000",26,203,0,203
1728,Cremonese,Serie A,ITA,Forward,"560,000",29,322,0,322
1729,SC Freiburg,Bundesliga,GER,Midfilder,"560,000",32,361,0,361
1730,VfL Bochum,Bundesliga,GRE,Defender,"560,000",28,173,32,205
1731,Hoffenheim,Bundesliga,GER,Midfilder,"560,000",27,194,0,194
1732,FC Augsburg,Bundesliga,BIH,Forward,"560,000",24,140,13,153
1733,1. FC Koln,Bundesliga,ARM,Midfilder,"560,000",29,268,34,302
1734,VfB Stuttgart,Bundesliga,GER,Goalkeeper,"560,000",27,147,0,147
1735,Brianza,Serie A,ITA,Midfilder,"560,000",28,212,0,212
1736,1. FC Koln,Bundesliga,AUT,Defender,"560,000",24,191,3,194
1737,SC Freiburg,Bundesliga,AUT,Defender,"560,000",26,200,9,209
1738,SV Werder,Bundesliga,BUL,Midfilder,"559,000",22,51,0,51
1739,Bayer 04,Bundesliga,AUT,Goalkeeper,"559,000",25,156,3,159
1740,Real San Sebastian,La Liga,ESP,Midfilder,"559,000",25,139,0,139
1741,Mainz 05,Bundesliga,MAR,Midfilder,"559,000",24,87,18,105
1742,Salernitana,Serie A,AUT,Defender,"559,000",21,55,0,55
1743,Sporting CP,Primiera Liga,URU,Goalkeeper,"554,000",22,53,0,53
1744,Vigo,La Liga,PER,Defender,"554,000",27,180,75,255
1745,Bologna,Serie A,SUI,Midfilder,"552,000",25,176,10,186
1746,Verona,Serie A,FRA,Midfilder,"552,000",28,210,0,210
1747,Lazio,Serie A,ESP,Defender,"552,000",22,74,0,74
1748,Empoli,Serie A,SVN,Defender,"552,000",26,216,37,253
1749,Udinese,Serie A,BRA,Midfilder,"552,000",27,216,5,221
1750,Atalanta,Serie A,DEN,Forward,"552,000",19,37,0,37
1751,Toulouse FC,Ligue 1 Uber Eats,SRB,Forward,"544,000",24,172,3,175
1752,Brianza,Serie A,BRA,Defender,"543,000",23,87,0,87
1753,Rennes,Ligue 1 Uber Eats,FRA,Defender,"542,000",20,65,0,65
1754,Getafe,La Liga,ESP,Midfilder,"542,000",25,183,0,183
1755,Getafe,La Liga,URU,Defender,"542,000",34,420,6,426
1756,Brest,Ligue 1 Uber Eats,FRA,Forward,"541,000",35,338,30,368
1757,Cadiz,La Liga,ESP,Defender,"541,000",33,391,0,391
1758,FC Augsburg,Bundesliga,POL,Defender,"541,000",24,168,3,171
1759,FC Nantes,Ligue 1 Uber Eats,CMR,Forward,"538,000",23,108,11,119
1760,Troyes,Ligue 1 Uber Eats,USA,Defender,"538,000",25,143,4,147
1761,Valencia,La Liga,POR,Defender,"538,000",23,61,0,61
1762,LOSC,Ligue 1 Uber Eats,ENG,Midfilder,"538,000",22,62,0,62
1763,VfB Stuttgart,Bundesliga,GER,Defender,"538,000",21,77,0,77
1764,RC Lens,Ligue 1 Uber Eats,FRA,Forward,"538,000",31,253,0,253
1765,Troyes,Ligue 1 Uber Eats,ECU,Defender,"536,000",22,59,7,66
1766,FC Nantes,Ligue 1 Uber Eats,FRA,Defender,"536,000",26,210,0,210
1767,Atletico Pamplona,La Liga,CRO,Forward,"534,000",31,359,14,373
1768,Atletico Pamplona,La Liga,ESP,Goalkeeper,"534,000",29,267,0,267
1769,Salernitana,Serie A,ITA,Defender,"533,000",20,23,0,23
1770,Salernitana,Serie A,ITA,Midfilder,"533,000",22,41,0,41
1771,LOSC,Ligue 1 Uber Eats,BRA,Defender,"530,000",23,89,0,89
1772,LOSC,Ligue 1 Uber Eats,FRA,Goalkeeper,"530,000",20,36,0,36
1773,OGC Nice,Ligue 1 Uber Eats,ITA,Defender,"527,000",20,24,0,24
1774,Cremonese,Serie A,ITA,Defender,"526,000",29,209,0,209
1775,Almeria,La Liga,BEL,Forward,"526,000",21,57,0,57
1776,Verona,Serie A,SCO,Defender,"524,000",20,70,0,70
1777,Mallorca,La Liga,KOR,Midfilder,"523,000",21,105,6,111
1778,Vallecano,La Liga,ESP,Midfilder,"523,000",26,262,0,262
1779,Valladolid,La Liga,ESP,Defender,"523,000",25,125,0,125
1780,Vallecano,La Liga,ESP,Midfilder,"523,000",28,253,0,253
1781,Nottm Forest,Premier League,POR,Midfilder,"520,000",29,238,0,238
1782,Leicester,Premier League,ENG,Defender,"520,000",21,14,0,14
1783,Southampton,Premier League,ENG,Defender,"520,000",19,28,0,28
1784,Newcastle,Premier League,SCO,Midfilder,"520,000",19,28,0,28
1785,OM,Ligue 1 Uber Eats,BFA,Defender,"520,000",21,63,26,89
1786,Wolves,Premier League,IRL,Midfilder,"520,000",19,3,0,3
1787,Santa Clara,Primiera Liga,SRB,Forward,"520,000",19,80,0,80
1788,West Ham,Premier League,BRA,Defender,"520,000",20,14,0,14
1789,Sassuolo,Serie A,BRA,Defender,"520,000",23,39,0,39
1790,FC Augsburg,Bundesliga,GER,Midfilder,"517,000",26,81,0,81
1791,FC Augsburg,Bundesliga,SUI,Midfilder,"517,000",24,173,24,197
1792,Torino,Serie A,SEN,Forward,"516,000",21,42,0,42
1793,Troyes,Ligue 1 Uber Eats,FRA,Midfilder,"516,000",31,327,0,327
1794,VfL Bochum,Bundesliga,GER,Midfilder,"516,000",31,303,0,303
1795,Troyes,Ligue 1 Uber Eats,FRA,Goalkeeper,"516,000",36,98,0,98
1796,Almeria,La Liga,BRA,Defender,"516,000",18,19,0,19
1797,Eintracht Frankfurt,Bundesliga,FRA,Defender,"516,000",23,125,0,125
1798,Strasbourg,Ligue 1 Uber Eats,FRA,Midfilder,"515,000",34,395,0,395
1799,SV Werder,Bundesliga,DEN,Midfilder,"514,000",25,221,1,222
1800,Cadiz,La Liga,URU,Forward,"511,000",23,98,1,99
1801,Vallecano,La Liga,ESP,Forward,"510,000",21,96,0,96
1802,BRG,Primiera Liga,COL,Defender,"508,000",29,193,5,198
1803,Real San Sebastian,La Liga,ESP,Midfilder,"508,000",27,139,0,139
1804,Real San Sebastian,La Liga,ESP,Defender,"508,000",25,103,0,103
1805,Brest,Ligue 1 Uber Eats,FRA,Defender,"508,000",27,161,0,161
1806,Vigo,La Liga,ESP,Midfilder,"507,000",23,211,1,212
1807,Espanyol,La Liga,ESP,Midfilder,"507,000",26,239,0,239
1808,FC Lorient,Ligue 1 Uber Eats,TUN,Defender,"504,000",24,100,20,120
1809,FC Lorient,Ligue 1 Uber Eats,COD,Defender,"504,000",25,110,2,112
1810,A. Bilbao,La Liga,ESP,Defender,"502,000",33,382,0,382
1811,Verona,Serie A,DEN,Midfilder,"501,000",26,144,1,145
1812,Borussia M'gladbach,Bundesliga,IRL,Midfilder,"499,000",21,56,0,56
1813,AC Ajaccio,Ligue 1 Uber Eats,FRA,Midfilder,"492,000",35,431,0,431
1814,Sassuolo,Serie A,BRA,Midfilder,"491,000",24,99,1,100
1815,RC Lens,Ligue 1 Uber Eats,POL,Defender,"490,000",27,295,24,319
1816,Real Hispalis,La Liga,BRA,Defender,"485,000",22,103,0,103
1817,SV Werder,Bundesliga,AUT,Defender,"484,000",24,123,5,128
1818,Salento,Serie A,ITA,Defender,"484,000",32,345,0,345
1819,Juventus,Serie A,ITA,Midfilder,"483,000",19,36,0,36
1820,Empoli,Serie A,ITA,Forward,"483,000",22,104,0,104
1821,Juventus,Serie A,ITA,Goalkeeper,"483,000",32,209,0,209
1822,Fiorentina,Serie A,ITA,Goalkeeper,"483,000",32,187,0,187
1823,Vallecano,La Liga,SEN,Midfilder,"479,000",28,174,0,174
1824,Valladolid,La Liga,VEN,Midfilder,"479,000",29,328,36,364
1825,Valladolid,La Liga,MAR,Defender,"478,000",30,198,20,218
1826,Empoli,Serie A,KOS,Goalkeeper,"478,000",34,216,35,251
1827,Bologna,Serie A,ITA,Defender,"478,000",22,32,0,32
1828,Salento,Serie A,ITA,Forward,"478,000",20,55,0,55
1829,Empoli,Serie A,ITA,Forward,"478,000",21,43,0,43
1830,Verona,Serie A,ITA,Defender,"478,000",25,140,0,140
1831,Spezia,Serie A,ITA,Forward,"478,000",20,15,0,15
1832,AC Ajaccio,Ligue 1 Uber Eats,SEN,Forward,"478,000",22,143,0,143
1833,FC Porto,Primiera Liga,NGA,Defender,"477,000",25,146,11,157
1834,Verona,Serie A,SLE,Forward,"477,000",21,33,0,33
1835,Valencia,La Liga,POR,Midfilder,"476,000",22,98,0,98
1836,VfL Bochum,Bundesliga,SRB,Defender,"473,000",23,98,1,99
1837,Toulouse FC,Ligue 1 Uber Eats,ENG,Forward,"471,000",27,200,0,200
1838,Toulouse FC,Ligue 1 Uber Eats,FRA,Goalkeeper,"471,000",29,153,0,153
1839,FC Lorient,Ligue 1 Uber Eats,FRA,Defender,"467,000",28,190,0,190
1840,FC Lorient,Ligue 1 Uber Eats,SEN,Forward,"467,000",22,53,11,64
1841,FC Lorient,Ligue 1 Uber Eats,MLI,Forward,"467,000",23,103,14,117
1842,Salernitana,Serie A,SVK,Defender,"466,000",30,242,30,272
1843,Troyes,Ligue 1 Uber Eats,FRA,Defender,"464,000",36,407,36,443
1844,Montpellier,Ligue 1 Uber Eats,URU,Defender,"464,000",26,142,3,145
1845,Troyes,Ligue 1 Uber Eats,POR,Defender,"464,000",24,115,0,115
1846,SC Freiburg,Bundesliga,GER,Forward,"463,000",33,446,2,448
1847,Vigo,La Liga,BRA,Goalkeeper,"462,000",37,422,10,432
1848,Espanyol,La Liga,ESP,Defender,"462,000",24,141,0,141
1849,Juventus,Serie A,ENG,Midfilder,"461,000",18,1,0,1
1850,SC Freiburg,Bundesliga,GER,Goalkeeper,"459,000",29,224,0,224
1851,FC Nantes,Ligue 1 Uber Eats,CMR,Defender,"459,000",27,237,11,248
1852,Brianza,Serie A,CRO,Forward,"457,000",27,280,2,282
1853,Cremonese,Serie A,ITA,Forward,"455,000",23,70,0,70
1854,VfB Stuttgart,Bundesliga,POR,Forward,"453,000",20,66,0,66
1855,Chaves,Primiera Liga,RSA,Forward,"452,000",25,163,13,176
1856,RC Lens,Ligue 1 Uber Eats,COL,Defender,"452,000",29,214,3,217
1857,Getafe,La Liga,SRB,Defender,"451,000",32,306,32,338
1858,Vigo,La Liga,ARG,Defender,"451,000",30,173,0,173
1859,Cadiz,La Liga,ESP,Forward,"451,000",30,275,0,275
1860,Espanyol,La Liga,ESP,Forward,"450,000",24,156,0,156
1861,Eintracht Frankfurt,Bundesliga,GER,Defender,"448,000",20,62,0,62
1862,Sampdoria,Serie A,ALG,Midfilder,"448,000",24,98,0,98
1863,VfB Stuttgart,Bundesliga,JPN,Defender,"448,000",29,353,41,394
1864,1. FC Koln,Bundesliga,GRE,Midfilder,"448,000",24,155,23,178
1865,Clermont,Ligue 1 Uber Eats,BEL,Defender,"448,000",25,144,0,144
1866,1. FC Koln,Bundesliga,GER,Forward,"448,000",24,169,0,169
1867,VfL Bochum,Bundesliga,CRC,Defender,"448,000",32,241,79,320
1868,Valencia,La Liga,USA,Midfilder,"448,000",19,88,19,107
1869,Cremonese,Serie A,AUT,Defender,"448,000",21,127,0,127
1870,Union Berlin,Bundesliga,NED,Defender,"448,000",24,150,0,150
1871,Strasbourg,Ligue 1 Uber Eats,FRA,Defender,"448,000",30,201,0,201
1872,Atletico Pamplona,La Liga,SRB,Midfilder,"445,000",30,261,3,264
1873,Angers SCO,Ligue 1 Uber Eats,SVN,Defender,"441,000",29,285,20,305
1874,Reims,Ligue 1 Uber Eats,NED,Defender,"441,000",24,123,0,123
1875,Torino,Serie A,GLP,Defender,"441,000",24,121,4,125
1876,Angers SCO,Ligue 1 Uber Eats,FRA,Defender,"441,000",22,42,0,42
1877,Verona,Serie A,ITA,Defender,"441,000",19,1,0,1
1878,Verona,Serie A,ITA,Defender,"441,000",18,4,0,4
1879,Santa Clara,Primiera Liga,BRA,Forward,"440,000",20,21,0,21
1880,Sassuolo,Serie A,TUR,Defender,"440,000",23,172,18,190
1881,Bologna,Serie A,GRE,Defender,"440,000",26,164,5,169
1882,Almeria,La Liga,BRA,Defender,"438,000",28,188,0,188
1883,Almeria,La Liga,POR,Midfilder,"438,000",21,90,0,90
1884,A. Bilbao,La Liga,ESP,Midfilder,"438,000",23,160,0,160
1885,Benfica,Primiera Liga,POR,Midfilder,"437,000",27,198,0,198
1886,Sporting CP,Primiera Liga,POR,Midfilder,"436,000",23,83,0,83
1887,Vallecano,La Liga,GHA,Defender,"436,000",24,107,0,107
1888,Elche,La Liga,ESP,Defender,"436,000",33,413,0,413
1889,Elche,La Liga,ESP,Defender,"436,000",32,405,0,405
1890,Valladolid,La Liga,ESP,Defender,"436,000",33,271,0,271
1891,Mallorca,La Liga,SVK,Defender,"436,000",26,290,13,303
1892,Mallorca,La Liga,SEN,Forward,"436,000",26,180,4,184
1893,Toulouse FC,Ligue 1 Uber Eats,DEN,Defender,"435,000",27,227,0,227
1894,Brest,Ligue 1 Uber Eats,BEN,Forward,"435,000",27,230,42,272
1895,Brest,Ligue 1 Uber Eats,POR,Midfilder,"435,000",25,193,0,193
1896,Espanyol,La Liga,ESP,Defender,"432,000",26,212,0,212
1897,FC Porto,Primiera Liga,BRA,Forward,"432,000",29,220,0,220
1898,Verona,Serie A,ITA,Goalkeeper,"431,000",26,219,0,219
1899,VfL Bochum,Bundesliga,GER,Midfilder,"430,000",22,23,0,23
1900,Union Berlin,Bundesliga,GER,Defender,"430,000",30,333,0,333
1901,Almeria,La Liga,ESP,Midfilder,"430,000",28,261,0,261
1902,Espanyol,La Liga,ESP,Defender,"430,000",24,163,1,164
1903,Borussia M'gladbach,Bundesliga,FRA,Defender,"430,000",24,11,0,11
1904,VfL Bochum,Bundesliga,PHI,Defender,"430,000",27,181,2,183
1905,Hoffenheim,Bundesliga,GER,Midfilder,"430,000",18,6,0,6
1906,FC Augsburg,Bundesliga,FIN,Midfilder,"430,000",24,109,20,129
1907,Troyes,Ligue 1 Uber Eats,GUF,Defender,"428,000",29,198,2,200
1908,Clermont,Ligue 1 Uber Eats,KOS,Midfilder,"428,000",29,258,22,280
1909,Troyes,Ligue 1 Uber Eats,CAN,Forward,"428,000",23,142,6,148
1910,Clermont,Ligue 1 Uber Eats,FRA,Midfilder,"428,000",34,417,0,417
1911,FC Porto,Primiera Liga,POR,Defender,"427,000",28,232,0,232
1912,Salernitana,Serie A,CHI,Forward,"426,000",22,98,9,107
1913,Brianza,Serie A,BRA,Defender,"426,000",26,171,0,171
1914,BRG,Primiera Liga,POR,Forward,"426,000",27,280,4,284
1915,Montpellier,Ligue 1 Uber Eats,FRA,Midfilder,"426,000",20,91,0,91
1916,Arouca,Primiera Liga,CIV,Midfilder,"421,000",24,122,1,123
1917,Cremonese,Serie A,CHI,Midfilder,"421,000",25,163,12,175
1918,FC Nantes,Ligue 1 Uber Eats,FRA,Defender,"420,000",20,35,0,35
1919,RC Lens,Ligue 1 Uber Eats,CPV,Defender,"417,000",30,186,13,199
1920,Wolves,Premier League,POR,Defender,"416,000",23,43,0,43
1921,VTSC,Primiera Liga,IRL,Midfilder,"416,000",23,60,0,60
1922,Angers SCO,Ligue 1 Uber Eats,SEN,Forward,"416,000",21,28,4,32
1923,Brighton,Premier League,SWE,Midfilder,"416,000",18,37,0,37
1924,FC Augsburg,Bundesliga,FRA,Forward,"416,000",20,80,0,80
1925,Cadiz,La Liga,ESP,Midfilder,"415,000",31,354,0,354
1926,Udinese,Serie A,SRB,Midfilder,"415,000",20,42,0,42
1927,AS Monaco,Ligue 1 Uber Eats,FRA,Midfilder,"413,000",23,111,0,111
1928,LOSC,Ligue 1 Uber Eats,POR,Defender,"413,000",22,68,0,68
1929,Salernitana,Serie A,CRO,Defender,"412,000",22,125,4,129
1930,Angers SCO,Ligue 1 Uber Eats,FRA,Midfilder,"412,000",35,359,0,359
1931,SC Freiburg,Bundesliga,GER,Defender,"412,000",31,234,0,234
1932,Valencia,La Liga,SUI,Defender,"412,000",24,151,9,160
1933,Sporting CP,Primiera Liga,POR,Defender,"412,000",29,133,0,133
1934,Valencia,La Liga,ESP,Defender,"412,000",19,37,0,37
1935,Verona,Serie A,COL,Defender,"411,000",21,45,0,45
1936,Montpellier,Ligue 1 Uber Eats,FRA,Midfilder,"411,000",24,157,0,157
1937,Almeria,La Liga,BRA,Forward,"410,000",30,267,0,267
1938,Mallorca,La Liga,ESP,Midfilder,"408,000",29,283,0,283
1939,Mallorca,La Liga,FRA,Midfilder,"408,000",31,209,5,214
1940,Mallorca,La Liga,ESP,Defender,"408,000",34,412,0,412
1941,Mallorca,La Liga,ESP,Midfilder,"408,000",34,494,0,494
1942,Girona,La Liga,COL,Defender,"408,000",33,395,0,395
1943,Mallorca,La Liga,ESP,Forward,"408,000",35,501,0,501
1944,Torino,Serie A,FRA,Defender,"405,000",29,180,0,180
1945,Angers SCO,Ligue 1 Uber Eats,FRA,Forward,"404,000",28,212,0,212
1946,SC Freiburg,Bundesliga,GER,Forward,"403,000",28,296,0,296
1947,Valencia,La Liga,GLP,Defender,"403,000",29,243,2,245
1948,BRG,Primiera Liga,ESP,Defender,"403,000",22,144,0,144
1949,Real Hispalis,La Liga,ESP,Goalkeeper,"403,000",24,101,0,101
1950,Villarreal,La Liga,ESP,Defender,"403,000",21,99,0,99
1951,Vigo,La Liga,ESP,Midfilder,"403,000",20,76,0,76
1952,BRG,Primiera Liga,BRA,Goalkeeper,"401,000",30,214,0,214
1953,Elche,La Liga,ESP,Defender,"399,000",20,42,0,42
1954,Elche,La Liga,ARG,Forward,"399,000",26,207,1,208
1955,Bologna,Serie A,URU,Defender,"399,000",20,44,0,44
1956,Toulouse FC,Ligue 1 Uber Eats,SUI,Midfilder,"398,000",26,213,0,213
1957,Toulouse FC,Ligue 1 Uber Eats,DEN,Defender,"398,000",25,104,0,104
1958,Toulouse FC,Ligue 1 Uber Eats,BRA,Forward,"398,000",26,202,0,202
1959,Villarreal,La Liga,ESP,Forward,"398,000",21,63,0,63
1960,Sampdoria,Serie A,ITA,Defender,"397,000",28,337,0,337
1961,Parthenope,Serie A,ITA,Forward,"397,000",23,130,1,131
1962,FC Lorient,Ligue 1 Uber Eats,FRA,Midfilder,"395,000",21,86,0,86
1963,AJ Auxerre,Ligue 1 Uber Eats,SEN,Forward,"395,000",27,264,23,287
1964,FC Lorient,Ligue 1 Uber Eats,FRA,Defender,"395,000",32,392,0,392
1965,OL,Ligue 1 Uber Eats,BRA,Forward,"393,000",22,24,0,24
1966,Empoli,Serie A,POL,Defender,"393,000",22,90,3,93
1967,BRG,Primiera Liga,POR,Midfilder,"392,000",25,162,0,162
1968,FC Porto,Primiera Liga,POR,Midfilder,"392,000",25,114,0,114
1969,FC Porto,Primiera Liga,BRA,Goalkeeper,"392,000",28,79,0,79
1970,Girona,La Liga,ESP,Midfilder,"392,000",23,148,0,148
1971,Reims,Ligue 1 Uber Eats,NED,Forward,"392,000",24,121,0,121
1972,Chelsea,Premier League,ENG,Defender,"390,000",19,0,0,0
1973,Leicester,Premier League,ENG,Midfilder,"390,000",18,1,0,1
1974,Atletico Pamplona,La Liga,ESP,Forward,"388,000",32,415,0,415
1975,Atletico Pamplona,La Liga,ESP,Defender,"388,000",30,236,0,236
1976,Atletico Pamplona,La Liga,ESP,Defender,"388,000",27,216,0,216
1977,VfB Stuttgart,Bundesliga,FRA,Defender,"387,000",21,60,0,60
1978,Almeria,La Liga,SRB,Defender,"383,000",26,200,0,200
1979,Almeria,La Liga,MLI,Forward,"383,000",20,65,13,78
1980,Valladolid,La Liga,ECU,Midfilder,"382,000",21,83,33,116
1981,FC Augsburg,Bundesliga,DEN,Defender,"381,000",26,142,0,142
1982,SC Freiburg,Bundesliga,KOR,Midfilder,"381,000",22,111,7,118
1983,Benfica,Primiera Liga,POR,Defender,"381,000",18,10,0,10
1984,VfB Stuttgart,Bundesliga,GER,Forward,"381,000",26,225,0,225
1985,Brest,Ligue 1 Uber Eats,HON,Forward,"381,000",26,204,56,260
1986,Eintracht Frankfurt,Bundesliga,BRA,Defender,"381,000",23,65,0,65
1987,Eintracht Frankfurt,Bundesliga,POR,Defender,"381,000",25,135,0,135
1988,Eintracht Frankfurt,Bundesliga,JPN,Midfilder,"381,000",26,203,19,222
1989,VfB Stuttgart,Bundesliga,GER,Defender,"381,000",25,166,0,166
1990,Valladolid,La Liga,ESP,Midfilder,"381,000",25,170,0,170
1991,Mallorca,La Liga,ESP,Defender,"381,000",30,348,0,348
1992,Brianza,Serie A,POR,Forward,"379,000",24,150,0,150
1993,Cadiz,La Liga,ESP,Defender,"379,000",29,305,0,305
1994,Valencia,La Liga,ESP,Defender,"374,000",22,125,2,127
1995,Salento,Serie A,ITA,Defender,"369,000",22,56,0,56
1996,Cadiz,La Liga,ESP,Midfilder,"368,000",34,382,0,382
1997,Angers SCO,Ligue 1 Uber Eats,BEN,Defender,"367,000",28,210,17,227
1998,BRG,Primiera Liga,LBY,Midfilder,"365,000",26,120,40,160
1999,BRG,Primiera Liga,ESP,Forward,"365,000",22,133,2,135
2000,Tottenham,Premier League,ENG,Forward,"364,000",18,0,0,0
2001,Man City,Premier League,NOR,Midfilder,"364,000",19,1,0,1
2002,Man City,Premier League,ENG,Defender,"364,000",19,3,0,3
2003,Brentford,Premier League,ENG,Goalkeeper,"364,000",19,0,0,0
2004,Valencia,La Liga,ESP,Defender,"364,000",24,98,0,98
2005,Tottenham,Premier League,ENG,Midfilder,"364,000",18,0,0,0
2006,Torino,Serie A,FRA,Midfilder,"363,000",22,52,0,52
2007,Brest,Ligue 1 Uber Eats,FRA,Defender,"362,000",22,72,0,72
2008,Brest,Ligue 1 Uber Eats,FRA,Midfilder,"362,000",24,56,0,56
2009,Toulouse FC,Ligue 1 Uber Eats,MAR,Forward,"362,000",22,118,11,129
2010,Brest,Ligue 1 Uber Eats,FRA,Forward,"362,000",26,174,0,174
2011,AS Monaco,Ligue 1 Uber Eats,CHI,Defender,"361,000",28,176,40,216
2012,Valladolid,La Liga,ESP,Midfilder,"359,000",27,265,0,265
2013,AJ Auxerre,Ligue 1 Uber Eats,COM,Midfilder,"359,000",32,311,52,363
2014,Eintracht Frankfurt,Bundesliga,GER,Defender,"359,000",27,224,0,224
2015,Montpellier,Ligue 1 Uber Eats,FRA,Forward,"359,000",19,57,0,57
2016,Valencia,La Liga,ESP,Forward,"359,000",22,150,0,150
2017,Real Hispalis,La Liga,ESP,Defender,"357,000",22,80,1,81
2018,Clermont,Ligue 1 Uber Eats,POL,Defender,"356,000",25,219,1,220
2019,Clermont,Ligue 1 Uber Eats,FRA,Forward,"356,000",27,171,0,171
2020,Clermont,Ligue 1 Uber Eats,FRA,Defender,"356,000",25,90,0,90
2021,Almeria,La Liga,ESP,Midfilder,"355,000",30,391,0,391
2022,Sampdoria,Serie A,GRE,Defender,"355,000",29,146,6,152
2023,Torino,Serie A,ITA,Defender,"353,000",23,72,0,72
2024,Cremonese,Serie A,ITA,Midfilder,"353,000",32,400,0,400
2025,Valladolid,La Liga,ESP,Midfilder,"353,000",29,363,0,363
2026,Mallorca,La Liga,ESP,Defender,"353,000",22,119,0,119
2027,Elche,La Liga,FRA,Midfilder,"353,000",24,179,0,179
2028,Verona,Serie A,ITA,Goalkeeper,"352,000",27,125,0,125
2029,Verona,Serie A,GHA,Midfilder,"352,000",19,5,0,5
2030,BRG,Primiera Liga,FRA,Forward,"351,000",26,152,0,152
2031,OL,Ligue 1 Uber Eats,FRA,Goalkeeper,"349,000",35,322,0,322
2032,OL,Ligue 1 Uber Eats,FRA,Forward,"349,000",20,15,0,15
2033,Verona,Serie A,SWE,Defender,"349,000",23,119,0,119
2034,VfL Bochum,Bundesliga,JPN,Forward,"348,000",27,206,36,242
2035,Real San Sebastian,La Liga,ESP,Midfilder,"347,000",20,61,0,61
2036,Valencia,La Liga,ESP,Goalkeeper,"347,000",34,311,0,311
2037,VfB Stuttgart,Bundesliga,FRA,Midfilder,"345,000",20,11,0,11
2038,Espanyol,La Liga,ESP,Defender,"344,000",28,207,0,207
2039,OL,Ligue 1 Uber Eats,FRA,Defender,"344,000",19,30,0,30
2040,Mainz 05,Bundesliga,GER,Goalkeeper,"344,000",24,76,0,76
2041,BRG,Primiera Liga,POR,Midfilder,"343,000",32,414,17,431
2042,FC Nantes,Ligue 1 Uber Eats,COD,Midfilder,"343,000",26,104,15,119
2043,MRT,Primiera Liga,COL,Forward,"343,000",27,207,0,207
2044,Hertha Berlin,Bundesliga,GHA,Midfilder,"341,000",35,393,15,408
2045,Eintracht Frankfurt,Bundesliga,GER,Midfilder,"341,000",21,39,0,39
2046,Spezia,Serie A,POL,Defender,"340,000",24,156,0,156
2047,Chelsea,Premier League,ENG,Midfilder,"338,000",19,0,0,0
2048,RC Lens,Ligue 1 Uber Eats,CMR,Midfilder,"338,000",22,56,9,65
2049,RC Lens,Ligue 1 Uber Eats,MLI,Defender,"338,000",29,186,13,199
2050,Getafe,La Liga,ESP,Forward,"337,000",33,446,1,447
2051,Getafe,La Liga,ARG,Defender,"337,000",28,133,0,133
2052,Union Berlin,Bundesliga,SRB,Midfilder,"336,000",26,186,0,186
2053,Montpellier,Ligue 1 Uber Eats,FRA,Defender,"336,000",24,122,0,122
2054,Verona,Serie A,NED,Forward,"336,000",20,6,0,6
2055,VfL Bochum,Bundesliga,GER,Midfilder,"336,000",27,225,0,225
2056,Brentford,Premier League,GER,Forward,"336,000",20,51,0,51
2057,VfL Bochum,Bundesliga,GER,Forward,"336,000",29,315,0,315
2058,VfL Bochum,Bundesliga,BRA,Defender,"336,000",30,297,0,297
2059,Valladolid,La Liga,CAN,Forward,"336,000",27,209,52,261
2060,Empoli,Serie A,BEL,Defender,"336,000",20,22,0,22
2061,Atletico Pamplona,La Liga,ESP,Midfilder,"332,000",25,264,0,264
2062,Verona,Serie A,AUS,Midfilder,"332,000",26,128,19,147
2063,Angers SCO,Ligue 1 Uber Eats,FRA,Midfilder,"330,000",29,217,0,217
2064,VfL Bochum,Bundesliga,ENG,Defender,"329,000",23,53,0,53
2065,Udinese,Serie A,GNB,Forward,"328,000",24,152,0,152
2066,Fiorentina,Serie A,SRB,Defender,"328,000",23,42,5,47
2067,Verona,Serie A,POL,Defender,"328,000",27,254,8,262
2068,FC Lorient,Ligue 1 Uber Eats,FRA,Midfilder,"328,000",24,142,0,142
2069,Vallecano,La Liga,ESP,Defender,"325,000",24,152,0,152
2070,Valladolid,La Liga,ESP,Defender,"325,000",27,257,0,257
2071,LOSC,Ligue 1 Uber Eats,FRA,Defender,"325,000",21,76,0,76
2072,Villarreal,La Liga,DEN,Goalkeeper,"325,000",20,30,0,30
2073,Brest,Ligue 1 Uber Eats,MAR,Defender,"325,000",23,91,2,93
2074,OGC Nice,Ligue 1 Uber Eats,ALG,Forward,"323,000",22,62,3,65
2075,Hertha Berlin,Bundesliga,GER,Defender,"323,000",20,36,0,36
2076,BRG,Primiera Liga,POR,Forward,"321,000",28,227,0,227
2077,Clermont,Ligue 1 Uber Eats,FRA,Defender,"320,000",33,356,0,356
2078,Clermont,Ligue 1 Uber Eats,BRA,Defender,"320,000",25,91,0,91
2079,Salento,Serie A,ITA,Goalkeeper,"319,000",26,85,0,85
2080,Capitoline,Serie A,ITA,Midfilder,"319,000",20,13,0,13
2081,Salento,Serie A,ITA,Defender,"319,000",22,53,0,53
2082,Udinese,Serie A,ITA,Goalkeeper,"319,000",36,176,0,176
2083,Troyes,Ligue 1 Uber Eats,FRA,Midfilder,"319,000",20,63,0,63
2084,Rennes,Ligue 1 Uber Eats,FRA,Defender,"316,000",22,34,0,34
2085,Espanyol,La Liga,ESP,Midfilder,"315,000",26,225,0,225
2086,Vigo,La Liga,POR,Forward,"315,000",28,178,2,180
2087,Real San Sebastian,La Liga,ESP,Defender,"315,000",21,65,0,65
2088,AC Ajaccio,Ligue 1 Uber Eats,FRA,Midfilder,"315,000",37,480,0,480
2089,OL,Ligue 1 Uber Eats,BRA,Defender,"315,000",28,142,0,142
2090,VfB Stuttgart,Bundesliga,COL,Forward,"314,000",22,82,0,82
2091,SC Freiburg,Bundesliga,GER,Defender,"314,000",30,202,0,202
2092,SC Freiburg,Bundesliga,NED,Goalkeeper,"314,000",29,175,4,179
2093,BVT,Primiera Liga,SVK,Forward,"314,000",22,117,25,142
2094,FC Nantes,Ligue 1 Uber Eats,ESP,Midfilder,"314,000",25,116,0,116
2095,Newcastle,Premier League,ENG,Goalkeeper,"312,000",30,253,0,253
2096,Man City,Premier League,ENG,Forward,"312,000",20,7,0,7
2097,Man City,Premier League,NED,Goalkeeper,"312,000",18,0,0,0
2098,Brighton,Premier League,ENG,Goalkeeper,"312,000",22,33,0,33
2099,Southampton,Premier League,ESP,Defender,"312,000",18,0,0,0
2100,Strasbourg,Ligue 1 Uber Eats,FRA,Defender,"312,000",25,81,0,81
2101,A. Bilbao,La Liga,ESP,Goalkeeper,"311,000",21,63,0,63
2102,VfL Bochum,Bundesliga,POL,Midfilder,"310,000",29,271,21,292
2103,Brest,Ligue 1 Uber Eats,FRA,Midfilder,"310,000",26,201,0,201
2104,VfL Bochum,Bundesliga,FRA,Midfilder,"310,000",36,536,0,536
2105,Brest,Ligue 1 Uber Eats,FRA,Defender,"309,000",25,171,0,171
2106,AJ Auxerre,Ligue 1 Uber Eats,FRA,Midfilder,"309,000",31,336,0,336
2107,Montpellier,Ligue 1 Uber Eats,ENG,Forward,"309,000",24,155,0,155
2108,Brest,Ligue 1 Uber Eats,ALG,Midfilder,"309,000",28,264,10,274
2109,OGC Nice,Ligue 1 Uber Eats,FRA,Midfilder,"307,000",21,55,0,55
2110,FC Nantes,Ligue 1 Uber Eats,FRA,Forward,"307,000",21,58,0,58
2111,Atletico Pamplona,La Liga,ESP,Midfilder,"304,000",28,211,0,211
2112,Girona,La Liga,ESP,Midfilder,"303,000",22,79,0,79
2113,P. Ferreira,Primiera Liga,POR,Midfilder,"303,000",20,48,0,48
2114,Sampdoria,Serie A,TUR,Midfilder,"302,000",18,13,0,13
2115,AJ Auxerre,Ligue 1 Uber Eats,GHA,Defender,"302,000",24,137,11,148
2116,Brianza,Serie A,ITA,Defender,"302,000",32,274,0,274
2117,VfL Bochum,Bundesliga,CGO,Forward,"301,000",26,167,18,185
2118,Schalke 04,Bundesliga,JPN,Midfilder,"301,000",21,29,0,29
2119,Union Berlin,Bundesliga,GER,Defender,"301,000",24,120,0,120
2120,VfB Stuttgart,Bundesliga,GER,Forward,"301,000",19,15,0,15
2121,Schalke 04,Bundesliga,GER,Defender,"301,000",22,79,0,79
2122,Real Hispalis,La Liga,CIV,Midfilder,"300,000",24,134,4,138
2123,Capitoline,Serie A,ITA,Goalkeeper,"300,000",20,0,0,0
2124,Almeria,La Liga,POR,Forward,"299,000",32,240,2,242
2125,Almeria,La Liga,FRA,Defender,"299,000",24,109,0,109
2126,Almeria,La Liga,ESP,Midfilder,"299,000",21,37,0,37
2127,Strasbourg,Ligue 1 Uber Eats,FRA,Defender,"298,000",32,280,0,280
2128,Strasbourg,Ligue 1 Uber Eats,UKR,Defender,"298,000",27,230,26,256
2129,Cadiz,La Liga,ESP,Forward,"298,000",25,197,0,197
2130,Elche,La Liga,ESP,Midfilder,"298,000",25,175,0,175
2131,Girona,La Liga,ESP,Midfilder,"298,000",27,250,0,250
2132,Elche,La Liga,CHI,Defender,"298,000",30,287,33,320
2133,Mallorca,La Liga,SRB,Defender,"298,000",29,208,34,242
2134,Elche,La Liga,ESP,Forward,"298,000",29,317,0,317
2135,Mallorca,La Liga,GHA,Midfilder,"298,000",26,205,18,223
2136,Estoril Praia,Primiera Liga,FRA,Midfilder,"293,000",23,75,0,75
2137,Reims,Ligue 1 Uber Eats,ZIM,Midfilder,"293,000",26,150,22,172
2138,LOSC,Ligue 1 Uber Eats,SWE,Defender,"293,000",23,151,0,151
2139,BRG,Primiera Liga,BRA,Defender,"292,000",26,121,0,121
2140,Hertha Berlin,Bundesliga,DEN,Goalkeeper,"291,000",23,76,1,77
2141,FC Porto,Primiera Liga,ENG,Forward,"291,000",22,94,0,94
2142,BRG,Primiera Liga,POR,Defender,"291,000",30,300,1,301
2143,Union Berlin,Bundesliga,GER,Midfilder,"291,000",27,200,0,200
2144,Reims,Ligue 1 Uber Eats,FRA,Goalkeeper,"291,000",41,665,0,665
2145,Angers SCO,Ligue 1 Uber Eats,SEN,Midfilder,"291,000",27,197,7,204
2146,BRG,Primiera Liga,POR,Defender,"290,000",32,267,0,267
2147,FC Nantes,Ligue 1 Uber Eats,FRA,Defender,"290,000",31,359,1,360
2148,Toulouse FC,Ligue 1 Uber Eats,CHI,Defender,"289,000",25,167,13,180
2149,Brest,Ligue 1 Uber Eats,FRA,Forward,"289,000",24,109,0,109
2150,Angers SCO,Ligue 1 Uber Eats,SEN,Forward,"287,000",23,141,0,141
2151,FC Lorient,Ligue 1 Uber Eats,ITA,Goalkeeper,"287,000",34,219,0,219
2152,AJ Auxerre,Ligue 1 Uber Eats,BRA,Defender,"287,000",29,191,0,191
2153,FC Lorient,Ligue 1 Uber Eats,NGA,Midfilder,"287,000",26,132,4,136
2154,Espanyol,La Liga,ALB,Midfilder,"286,000",25,178,21,199
2155,Espanyol,La Liga,ESP,Defender,"286,000",21,49,0,49
2156,BRG,Primiera Liga,POR,Midfilder,"285,000",34,395,0,395
2157,Troyes,Ligue 1 Uber Eats,MLI,Defender,"284,000",25,122,10,132
2158,Troyes,Ligue 1 Uber Eats,FRA,Defender,"284,000",21,17,0,17
2159,Clermont,Ligue 1 Uber Eats,AUT,Midfilder,"284,000",21,73,0,73
2160,Girona,La Liga,ARG,Forward,"282,000",23,127,0,127
2161,Empoli,Serie A,ITA,Midfilder,"282,000",19,0,0,0
2162,Valencia,La Liga,ESP,Goalkeeper,"281,000",24,83,0,83
2163,AJ Auxerre,Ligue 1 Uber Eats,MLI,Midfilder,"280,000",30,303,10,313
2164,FC Porto,Primiera Liga,POR,Defender,"280,000",28,217,0,217
2165,FC Porto,Primiera Liga,POR,Goalkeeper,"280,000",30,267,1,268
2166,AC Ajaccio,Ligue 1 Uber Eats,FRA,Midfilder,"280,000",25,140,0,140
2167,AC Ajaccio,Ligue 1 Uber Eats,CMR,Defender,"280,000",24,145,0,145
2168,Reims,Ligue 1 Uber Eats,CIV,Defender,"279,000",25,76,2,78
2169,Casa Pia,Primiera Liga,JPN,Defender,"278,000",25,199,6,205
2170,Spezia,Serie A,ESP,Defender,"276,000",24,125,0,125
2171,Santa Clara,Primiera Liga,GNB,Defender,"276,000",28,202,19,221
2172,Sporting CP,Primiera Liga,ARG,Midfilder,"276,000",19,34,0,34
2173,Sporting CP,Primiera Liga,POR,Forward,"276,000",19,35,0,35
2174,SV Werder,Bundesliga,GER,Midfilder,"274,000",24,171,0,171
2175,1. FC Koln,Bundesliga,GER,Forward,"273,000",24,121,0,121
2176,AJ Auxerre,Ligue 1 Uber Eats,FRA,Forward,"272,000",26,139,0,139
2177,RC Lens,Ligue 1 Uber Eats,FRA,Defender,"270,000",25,138,0,138
2178,Clermont,Ligue 1 Uber Eats,GAB,Midfilder,"270,000",27,185,17,202
2179,Girona,La Liga,ESP,Defender,"270,000",21,45,0,45
2180,Vallecano,La Liga,ESP,Midfilder,"270,000",31,375,0,375
2181,Elche,La Liga,ESP,Midfilder,"270,000",27,277,0,277
2182,Valladolid,La Liga,URU,Defender,"270,000",28,202,0,202
2183,Borussia Dortmund,Bundesliga,ENG,Forward,"269,000",18,7,0,7
2184,1. FC Koln,Bundesliga,GER,Forward,"269,000",20,48,0,48
2185,Valladolid,La Liga,CMR,Midfilder,"269,000",24,120,17,137
2186,VfL Bochum,Bundesliga,GER,Goalkeeper,"269,000",34,211,0,211
2187,RB Leipzig,Bundesliga,NOR,Goalkeeper,"269,000",31,210,38,248
2188,Clermont,Ligue 1 Uber Eats,TUN,Forward,"269,000",27,157,27,184
2189,VfL Bochum,Bundesliga,SWE,Goalkeeper,"269,000",24,128,0,128
2190,VfB Stuttgart,Bundesliga,GER,Goalkeeper,"269,000",24,135,0,135
2191,Empoli,Serie A,NGA,Defender,"269,000",26,136,10,146
2192,Salernitana,Serie A,SVN,Midfilder,"269,000",26,269,24,293
2193,Strasbourg,Ligue 1 Uber Eats,FRA,Defender,"268,000",23,48,0,48
2194,Cadiz,La Liga,ESP,Defender,"264,000",29,313,0,313
2195,Cadiz,La Liga,ESP,Forward,"264,000",27,183,0,183
2196,Almeria,La Liga,ESP,Goalkeeper,"263,000",32,236,0,236
2197,Empoli,Serie A,POL,Midfilder,"262,000",18,27,0,27
2198,Valladolid,La Liga,ESP,Goalkeeper,"261,000",33,268,0,268
2199,Valladolid,La Liga,ESP,Midfilder,"261,000",26,160,0,160
2200,Everton,Premier League,ENG,Goalkeeper,"260,000",38,346,0,346
2201,Troyes,Ligue 1 Uber Eats,POL,Goalkeeper,"260,000",25,165,0,165
2202,Arsenal,Premier League,ROU,Midfilder,"260,000",19,23,0,23
2203,Wolves,Premier League,JAM,Defender,"260,000",18,1,0,1
2204,Wolves,Premier League,ESP,Defender,"260,000",19,0,0,0
2205,Man UFC,Premier League,ENG,Defender,"260,000",20,18,0,18
2206,Man City,Premier League,NIR,Defender,"260,000",18,2,4,6
2207,Arsenal,Premier League,ENG,Forward,"260,000",18,2,0,2
2208,Crystal Palace,Premier League,IRL,Defender,"260,000",18,0,0,0
2209,Southampton,Premier League,ENG,Forward,"260,000",19,0,0,0
2210,Leeds,Premier League,ENG,Midfilder,"260,000",18,1,0,1
2211,AJ Auxerre,Ligue 1 Uber Eats,FRA,Midfilder,"260,000",21,98,0,98
2212,Girona,La Liga,BRA,Defender,"260,000",20,55,0,55
2213,Man UFC,Premier League,ENG,Goalkeeper,"260,000",22,77,0,77
2214,Chelsea,Premier League,NOR,Forward,"260,000",19,33,0,33
2215,Newcastle,Premier League,SCO,Defender,"260,000",20,1,0,1
2216,Aston Villa,Premier League,FIN,Goalkeeper,"260,000",20,22,0,22
2217,West Ham,Premier League,IRL,Midfilder,"260,000",20,17,0,17
2218,Nottm Forest,Premier League,USA,Forward,"260,000",20,65,0,65
2219,Wolves,Premier League,ENG,Defender,"260,000",19,47,0,47
2220,SV Werder,Bundesliga,AUT,Forward,"260,000",22,155,0,155
2221,Clermont,Ligue 1 Uber Eats,SRB,Forward,"259,000",27,190,0,190
2222,FC Lorient,Ligue 1 Uber Eats,CIV,Midfilder,"258,000",23,93,0,93
2223,FC Lorient,Ligue 1 Uber Eats,FRA,Midfilder,"258,000",20,72,0,72
2224,FC Lorient,Ligue 1 Uber Eats,BRA,Defender,"258,000",26,139,0,139
2225,AJ Auxerre,Ligue 1 Uber Eats,FRA,Defender,"258,000",29,214,0,214
2226,AJ Auxerre,Ligue 1 Uber Eats,CPV,Forward,"258,000",31,246,3,249
2227,VTSC,Primiera Liga,POR,Midfilder,"258,000",33,336,4,340
2228,Sporting CP,Primiera Liga,GHA,Midfilder,"258,000",18,7,12,19
2229,Eintracht Frankfurt,Bundesliga,GER,Goalkeeper,"258,000",33,162,0,162
2230,Brest,Ligue 1 Uber Eats,FRA,Defender,"258,000",30,243,0,243
2231,Espanyol,La Liga,ESP,Midfilder,"257,000",22,147,0,147
2232,Espanyol,La Liga,ESP,Forward,"257,000",24,144,1,145
2233,AS Monaco,Ligue 1 Uber Eats,BEL,Midfilder,"256,000",20,30,0,30
2234,FC Nantes,Ligue 1 Uber Eats,FRA,Midfilder,"255,000",26,193,0,193
2235,Troyes,Ligue 1 Uber Eats,GNB,Midfilder,"255,000",26,198,17,215
2236,Empoli,Serie A,ITA,Goalkeeper,"254,000",25,89,0,89
2237,AC Ajaccio,Ligue 1 Uber Eats,CGO,Defender,"252,000",26,115,16,131
2238,AC Ajaccio,Ligue 1 Uber Eats,BFA,Forward,"252,000",26,194,39,233
2239,Montpellier,Ligue 1 Uber Eats,SEN,Goalkeeper,"251,000",25,118,2,120
2240,Empoli,Serie A,NZL,Defender,"250,000",21,133,12,145
2241,Union Berlin,Bundesliga,POR,Defender,"248,000",23,106,0,106
2242,Atletico Pamplona,La Liga,ESP,Forward,"247,000",20,101,0,101
2243,1. FC Koln,Bundesliga,GER,Defender,"247,000",23,95,0,95
2244,FC Porto,Primiera Liga,POR,Defender,"247,000",22,68,0,68
2245,FC Porto,Primiera Liga,POR,Forward,"247,000",37,445,27,472
2246,AJ Auxerre,Ligue 1 Uber Eats,GUI,Defender,"244,000",30,169,6,175
2247,Almeria,La Liga,ESP,Defender,"244,000",23,81,0,81
2248,Almeria,La Liga,BRA,Midfilder,"244,000",20,31,0,31
2249,Vallecano,La Liga,MNE,Defender,"242,000",31,221,4,225
2250,Girona,La Liga,PER,Defender,"242,000",30,320,35,355
2251,Vallecano,La Liga,ESP,Defender,"242,000",35,438,3,441
2252,Elche,La Liga,ESP,Defender,"242,000",27,246,0,246
2253,Girona,La Liga,ESP,Midfilder,"242,000",25,177,0,177
2254,Verona,Serie A,ITA,Goalkeeper,"241,000",31,85,0,85
2255,Inter,Serie A,ITA,Goalkeeper,"241,000",39,482,0,482
2256,Salento,Serie A,FRA,Midfilder,"241,000",25,200,0,200
2257,Sassuolo,Serie A,CRO,Defender,"241,000",24,111,3,114
2258,Bayer 04,Bundesliga,GER,Goalkeeper,"241,000",29,126,0,126
2259,Famalicao,Primiera Liga,FRA,Midfilder,"240,000",23,100,0,100
2260,OGC Nice,Ligue 1 Uber Eats,POL,Goalkeeper,"237,000",22,16,0,16
2261,AJ Auxerre,Ligue 1 Uber Eats,MAR,Midfilder,"237,000",26,207,0,207
2262,SC Freiburg,Bundesliga,FRA,Defender,"236,000",20,65,0,65
2263,PTM,Primiera Liga,COL,Forward,"234,000",23,105,0,105
2264,Atletico Pamplona,La Liga,ESP,Defender,"234,000",22,84,0,84
2265,Rennes,Ligue 1 Uber Eats,FRA,Defender,"233,000",22,34,0,34
2266,Santa Clara,Primiera Liga,BRA,Forward,"232,000",25,60,0,60
2267,A. Madrid,La Liga,ESP,Midfilder,"232,000",19,3,0,3
2268,Toulouse FC,Ligue 1 Uber Eats,NOR,Goalkeeper,"231,000",24,75,0,75
2269,AJ Auxerre,Ligue 1 Uber Eats,FRA,Defender,"230,000",28,110,0,110
2270,BRG,Primiera Liga,TUR,Defender,"229,000",19,11,0,11
2271,Troyes,Ligue 1 Uber Eats,FRA,Defender,"228,000",20,33,0,33
2272,Vigo,La Liga,NOR,Forward,"227,000",22,125,1,126
2273,Fiorentina,Serie A,ITA,Midfilder,"227,000",19,4,0,4
2274,Famalicao,Primiera Liga,POR,Forward,"225,000",22,64,0,64
2275,Salento,Serie A,ISL,Midfilder,"225,000",21,82,12,94
2276,SC Freiburg,Bundesliga,GHA,Midfilder,"224,000",26,187,12,199
2277,Sassuolo,Serie A,MAR,Midfilder,"224,000",24,164,0,164
2278,Famalicao,Primiera Liga,ARG,Midfilder,"224,000",25,167,0,167
2279,FC Augsburg,Bundesliga,CRO,Forward,"224,000",20,93,0,93
2280,RB Leipzig,Bundesliga,GER,Goalkeeper,"224,000",31,296,0,296
2281,SV Werder,Bundesliga,GER,Defender,"224,000",24,136,0,136
2282,Toulouse FC,Ligue 1 Uber Eats,NED,Midfilder,"224,000",26,193,0,193
2283,Rennes,Ligue 1 Uber Eats,MAR,Forward,"224,000",21,16,0,16
2284,Reims,Ligue 1 Uber Eats,FRA,Forward,"224,000",23,80,0,80
2285,Hoffenheim,Bundesliga,GER,Midfilder,"224,000",22,88,0,88
2286,Troyes,Ligue 1 Uber Eats,FRA,Midfilder,"224,000",30,314,0,314
2287,Reims,Ligue 1 Uber Eats,NED,Midfilder,"224,000",23,153,0,153
2288,Torino,Serie A,SRB,Midfilder,"224,000",21,104,3,107
2289,Torino,Serie A,CIV,Defender,"224,000",21,72,2,74
2290,1. FC Koln,Bundesliga,GER,Midfilder,"224,000",20,56,0,56
2291,Montpellier,Ligue 1 Uber Eats,FRA,Defender,"224,000",23,54,0,54
2292,Strasbourg,Ligue 1 Uber Eats,JPN,Goalkeeper,"224,000",39,397,95,492
2293,Union Berlin,Bundesliga,DEN,Goalkeeper,"223,000",28,92,0,92
2294,Chaves,Primiera Liga,POR,Defender,"223,000",27,116,0,116
2295,Angers SCO,Ligue 1 Uber Eats,FRA,Goalkeeper,"220,000",22,38,0,38
2296,Reims,Ligue 1 Uber Eats,FRA,Forward,"220,000",22,43,0,43
2297,Valladolid,La Liga,ESP,Forward,"218,000",31,415,0,415
2298,FC Porto,Primiera Liga,POR,Forward,"217,000",21,63,0,63
2299,Brest,Ligue 1 Uber Eats,FRA,Defender,"217,000",30,306,0,306
2300,Toulouse FC,Ligue 1 Uber Eats,JPN,Forward,"217,000",26,226,3,229
2301,Angers SCO,Ligue 1 Uber Eats,ALG,Defender,"217,000",27,86,9,95
2302,Almeria,La Liga,ESP,Forward,"216,000",32,326,0,326
2303,AJ Auxerre,Ligue 1 Uber Eats,GHA,Midfilder,"215,000",24,117,2,119
2304,Mainz 05,Bundesliga,AUT,Forward,"215,000",21,73,0,73
2305,1. FC Koln,Bundesliga,GER,Defender,"215,000",26,104,0,104
2306,VfL Wolfsburg,Bundesliga,CZE,Midfilder,"215,000",18,3,0,3
2307,VfL Bochum,Bundesliga,GRE,Defender,"215,000",32,237,5,242
2308,Vallecano,La Liga,ESP,Midfilder,"215,000",26,210,0,210
2309,Elche,La Liga,COL,Defender,"215,000",29,269,5,274
2310,Mallorca,La Liga,SVK,Goalkeeper,"215,000",25,131,4,135
2311,FC Nantes,Ligue 1 Uber Eats,MLI,Defender,"214,000",30,131,10,141
2312,Clermont,Ligue 1 Uber Eats,ALG,Defender,"214,000",30,124,19,143
2313,Troyes,Ligue 1 Uber Eats,DEN,Defender,"214,000",23,98,0,98
2314,VfB Stuttgart,Bundesliga,GER,Midfilder,"213,000",20,27,0,27
2315,VTSC,Primiera Liga,POR,Goalkeeper,"213,000",27,214,0,214
2316,VTSC,Primiera Liga,POR,Midfilder,"213,000",29,277,0,277
2317,AC Ajaccio,Ligue 1 Uber Eats,GLP,Defender,"210,000",33,355,10,365
2318,Torino,Serie A,ITA,Goalkeeper,"210,000",22,69,0,69
2319,Brianza,Serie A,ARG,Defender,"209,000",19,0,0,0
2320,Brighton,Premier League,NIR,Forward,"208,000",20,0,0,0
2321,Man City,Premier League,SCO,Goalkeeper,"208,000",19,0,0,0
2322,Brentford,Premier League,ENG,Forward,"208,000",19,12,0,12
2323,Brighton,Premier League,ENG,Defender,"208,000",20,6,0,6
2324,Brighton,Premier League,NED,Defender,"208,000",22,72,0,72
2325,SV Werder,Bundesliga,ENG,Defender,"208,000",21,74,0,74
2326,Montpellier,Ligue 1 Uber Eats,FRA,Defender,"206,000",20,28,0,28
2327,Strasbourg,Ligue 1 Uber Eats,FRA,Midfilder,"206,000",24,159,0,159
2328,Cadiz,La Liga,ESP,Forward,"204,000",31,352,0,352
2329,AC Ajaccio,Ligue 1 Uber Eats,FRA,Goalkeeper,"204,000",33,305,0,305
2330,Troyes,Ligue 1 Uber Eats,SEN,Forward,"203,000",22,105,0,105
2331,VTSC,Primiera Liga,POR,Forward,"203,000",27,234,0,234
2332,BRG,Primiera Liga,BRA,Midfilder,"203,000",29,170,0,170
2333,VfB Stuttgart,Bundesliga,DEN,Defender,"202,000",22,87,0,87
2334,Vigo,La Liga,USA,Midfilder,"202,000",24,72,11,83
2335,1. FC Koln,Bundesliga,GER,Midfilder,"202,000",21,64,0,64
2336,MRT,Primiera Liga,CZE,Goalkeeper,"202,000",23,64,0,64
2337,Troyes,Ligue 1 Uber Eats,FRA,Goalkeeper,"202,000",29,183,0,183
2338,Borussia Dortmund,Bundesliga,GER,Goalkeeper,"202,000",31,219,0,219
2339,FC Augsburg,Bundesliga,GER,Defender,"202,000",22,90,0,90
2340,FC Augsburg,Bundesliga,CRO,Defender,"202,000",22,96,0,96
2341,P. Ferreira,Primiera Liga,BRA,Forward,"201,000",25,114,0,114
2342,Girona,La Liga,BRA,Forward,"200,000",20,46,0,46
2343,Troyes,Ligue 1 Uber Eats,FRA,Forward,"199,000",18,32,0,32
2344,Spezia,Serie A,POR,Defender,"196,000",24,110,0,110
2345,AJ Auxerre,Ligue 1 Uber Eats,MLI,Forward,"193,000",22,39,5,44
2346,Estoril Praia,Primiera Liga,ESP,Forward,"193,000",22,78,0,78
2347,Valladolid,La Liga,ESP,Midfilder,"192,000",22,122,0,122
2348,MRT,Primiera Liga,VEN,Forward,"192,000",24,97,0,97
2349,Reims,Ligue 1 Uber Eats,FRA,Goalkeeper,"191,000",26,93,0,93
2350,Benfica,Primiera Liga,FRA,Defender,"191,000",19,4,0,4
2351,Girona,La Liga,ESP,Goalkeeper,"190,000",34,399,0,399
2352,Valladolid,La Liga,ESP,Defender,"190,000",26,253,0,253
2353,Girona,La Liga,ESP,Defender,"190,000",31,332,0,332
2354,Cremonese,Serie A,SEN,Goalkeeper,"190,000",25,47,0,47
2355,Toulouse FC,Ligue 1 Uber Eats,SWE,Defender,"188,000",21,23,0,23
2356,SV Werder,Bundesliga,GER,Forward,"187,000",20,43,0,43
2357,AJ Auxerre,Ligue 1 Uber Eats,GUF,Goalkeeper,"187,000",29,136,28,164
2358,FC Lorient,Ligue 1 Uber Eats,FRA,Midfilder,"187,000",19,10,0,10
2359,FC Lorient,Ligue 1 Uber Eats,FRA,Forward,"187,000",20,25,0,25
2360,AJ Auxerre,Ligue 1 Uber Eats,MAD,Defender,"187,000",25,185,20,205
2361,Toulouse FC,Ligue 1 Uber Eats,GRE,Midfilder,"187,000",22,43,0,43
2362,Real San Sebastian,La Liga,ESP,Forward,"186,000",20,75,0,75
2363,BRG,Primiera Liga,SWE,Defender,"186,000",19,50,0,50
2364,VTSC,Primiera Liga,BRA,Forward,"186,000",25,93,0,93
2365,Casa Pia,Primiera Liga,POR,Midfilder,"186,000",22,80,0,80
2366,FC Nantes,Ligue 1 Uber Eats,SVN,Goalkeeper,"183,000",34,184,0,184
2367,Barcelona,La Liga,MEX,Defender,"183,000",21,100,3,103
2368,Chelsea,Premier League,ENG,Forward,"182,000",19,0,0,0
2369,Aston Villa,Premier League,ENG,Defender,"182,000",19,51,0,51
2370,Chelsea,Premier League,ENG,Defender,"182,000",18,0,0,0
2371,Chelsea,Premier League,NED,Defender,"182,000",22,51,0,51
2372,Chelsea,Premier League,ENG,Defender,"182,000",18,0,0,0
2373,Chelsea,Premier League,ENG,Defender,"182,000",20,0,0,0
2374,Udinese,Serie A,IRL,Defender,"181,000",20,40,0,40
2375,Cadiz,La Liga,ESP,Defender,"181,000",22,57,0,57
2376,Salento,Serie A,DEN,Midfilder,"181,000",23,129,0,129
2377,Santa Clara,Primiera Liga,PAR,Forward,"181,000",27,177,0,177
2378,Almeria,La Liga,ESP,Defender,"179,000",30,363,0,363
2379,1. FC Koln,Bundesliga,GER,Midfilder,"179,000",23,98,0,98
2380,FC Nantes,Ligue 1 Uber Eats,FRA,Goalkeeper,"179,000",26,61,0,61
2381,Estoril Praia,Primiera Liga,POR,Midfilder,"179,000",26,207,0,207
2382,Brest,Ligue 1 Uber Eats,SEN,Defender,"179,000",22,78,0,78
2383,Reims,Ligue 1 Uber Eats,BEL,Defender,"179,000",24,56,0,56
2384,Verona,Serie A,BEL,Forward,"179,000",22,89,0,89
2385,Spezia,Serie A,SWE,Defender,"179,000",22,81,0,81
2386,1. FC Koln,Bundesliga,LUX,Midfilder,"179,000",21,60,6,66
2387,Hoffenheim,Bundesliga,GER,Forward,"179,000",20,34,0,34
2388,Barcelona,La Liga,ESP,Defender,"179,000",18,24,0,24
2389,Barcelona,La Liga,ESP,Midfilder,"179,000",19,56,0,56
2390,Girona,La Liga,ESP,Defender,"178,000",24,164,0,164
2391,MRT,Primiera Liga,MOZ,Defender,"177,000",34,269,63,332
2392,VTSC,Primiera Liga,ANG,Defender,"177,000",29,184,4,188
2393,VTSC,Primiera Liga,VEN,Defender,"177,000",29,190,31,221
2394,Cadiz,La Liga,ESP,Goalkeeper,"176,000",28,131,0,131
2395,Cadiz,La Liga,SEN,Defender,"174,000",24,71,0,71
2396,Toulouse FC,Ligue 1 Uber Eats,AUS,Midfilder,"174,000",23,106,3,109
2397,SC Freiburg,Bundesliga,NED,Forward,"173,000",28,248,0,248
2398,Famalicao,Primiera Liga,POR,Defender,"173,000",23,51,0,51
2399,AJ Auxerre,Ligue 1 Uber Eats,FRA,Midfilder,"172,000",26,153,0,153
2400,Salernitana,Serie A,ITA,Defender,"172,000",27,203,0,203
2401,Mainz 05,Bundesliga,GER,Forward,"172,000",18,5,0,5
2402,VfL Wolfsburg,Bundesliga,GER,Defender,"172,000",18,0,0,0
2403,VfL Wolfsburg,Bundesliga,GER,Goalkeeper,"172,000",26,35,0,35
2404,VfL Bochum,Bundesliga,GHA,Midfilder,"172,000",28,277,3,280
2405,Clermont,Ligue 1 Uber Eats,ANG,Defender,"171,000",29,257,2,259
2406,PTM,Primiera Liga,COL,Defender,"171,000",20,28,0,28
2407,P. Ferreira,Primiera Liga,ARG,Midfilder,"170,000",34,339,19,358
2408,Rio Ave,Primiera Liga,ESP,Midfilder,"169,000",22,68,0,68
2409,Espanyol,La Liga,ESP,Midfilder,"169,000",21,108,0,108
2410,Estoril Praia,Primiera Liga,POR,Midfilder,"169,000",27,202,0,202
2411,A. Bilbao,La Liga,ESP,Midfilder,"169,000",23,136,0,136
2412,RB Leipzig,Bundesliga,GER,Defender,"168,000",18,0,0,0
2413,AC Ajaccio,Ligue 1 Uber Eats,FRA,Forward,"168,000",31,245,0,245
2414,AC Ajaccio,Ligue 1 Uber Eats,SUI,Midfilder,"168,000",25,127,0,127
2415,MRT,Primiera Liga,ESP,Forward,"168,000",20,46,0,46
2416,Rio Ave,Primiera Liga,BRA,Defender,"168,000",33,278,0,278
2417,Famalicao,Primiera Liga,VEN,Forward,"168,000",27,212,4,216
2418,AC Ajaccio,Ligue 1 Uber Eats,CIV,Defender,"168,000",25,93,1,94
2419,AC Ajaccio,Ligue 1 Uber Eats,FRA,Forward,"168,000",23,83,0,83
2420,Rennes,Ligue 1 Uber Eats,CMR,Defender,"167,000",20,28,1,29
2421,Juventus,Serie A,ITA,Forward,"166,000",20,33,0,33
2422,MRT,Primiera Liga,POR,Defender,"166,000",21,74,0,74
2423,Salento,Serie A,CZE,Midfilder,"165,000",18,30,0,30
2424,Salernitana,Serie A,ITA,Goalkeeper,"165,000",32,251,0,251
2425,Spezia,Serie A,ITA,Defender,"164,000",25,158,0,158
2426,Sampdoria,Serie A,ITA,Goalkeeper,"164,000",33,322,0,322
2427,Spezia,Serie A,GHA,Forward,"164,000",28,255,3,258
2428,Empoli,Serie A,ITA,Defender,"164,000",21,113,0,113
2429,Salento,Serie A,ITA,Defender,"164,000",32,270,0,270
2430,Lazio,Serie A,LTU,Goalkeeper,"164,000",25,51,0,51
2431,Atalanta,Serie A,ITA,Goalkeeper,"164,000",31,142,0,142
2432,LOSC,Ligue 1 Uber Eats,CMR,Midfilder,"163,000",18,2,0,2
2433,LOSC,Ligue 1 Uber Eats,CMR,Midfilder,"163,000",18,2,0,2
2434,1. FC Koln,Bundesliga,CRO,Defender,"162,000",21,92,0,92
2435,Angers SCO,Ligue 1 Uber Eats,FRA,Midfilder,"162,000",22,79,0,79
2436,Sampdoria,Serie A,ESP,Midfilder,"161,000",20,8,0,8
2437,Almeria,La Liga,ESP,Defender,"161,000",23,128,0,128
2438,Casa Pia,Primiera Liga,BRA,Forward,"160,000",25,97,0,97
2439,Estoril Praia,Primiera Liga,POR,Forward,"160,000",21,53,0,53
2440,Girona,La Liga,ESP,Forward,"160,000",31,432,0,432
2441,Elche,La Liga,ARG,Goalkeeper,"160,000",26,58,0,58
2442,Sampdoria,Serie A,ARG,Defender,"159,000",20,24,0,24
2443,Cremonese,Serie A,ITA,Goalkeeper,"159,000",22,89,0,89
2444,Bologna,Serie A,NGA,Forward,"159,000",24,113,0,113
2445,Salento,Serie A,NOR,Midfilder,"159,000",21,45,1,46
2446,Brest,Ligue 1 Uber Eats,ARG,Goalkeeper,"159,000",21,4,0,4
2447,BVT,Primiera Liga,COL,Midfilder,"158,000",29,206,10,216
2448,BVT,Primiera Liga,POR,Defender,"157,000",24,105,0,105
2449,Famalicao,Primiera Liga,BRA,Goalkeeper,"157,000",21,58,0,58
2450,Rio Ave,Primiera Liga,GRE,Defender,"157,000",33,287,39,326
2451,Estoril Praia,Primiera Liga,CMR,Midfilder,"157,000",26,97,11,108
2452,Benfica,Primiera Liga,POR,Midfilder,"157,000",19,40,0,40
2453,BVT,Primiera Liga,CGO,Midfilder,"157,000",25,147,14,161
2454,Estoril Praia,Primiera Liga,POR,Defender,"157,000",33,363,0,363
2455,PTM,Primiera Liga,COL,Forward,"157,000",28,207,0,207
2456,MRT,Primiera Liga,BRA,Defender,"157,000",28,129,0,129
2457,Famalicao,Primiera Liga,BRA,Midfilder,"157,000",22,75,0,75
2458,Gil Vicente,Primiera Liga,POR,Defender,"157,000",20,60,0,60
2459,Gil Vicente,Primiera Liga,POR,Defender,"157,000",29,259,0,259
2460,Sporting CP,Primiera Liga,POR,Midfilder,"157,000",19,9,0,9
2461,Sampdoria,Serie A,ITA,Forward,"156,000",19,1,0,1
2462,Chelsea,Premier League,ENG,Forward,"156,000",18,0,0,0
2463,Man City,Premier League,ENG,Midfilder,"156,000",18,0,0,0
2464,Arsenal,Premier League,NED,Midfilder,"156,000",19,0,0,0
2465,Tottenham,Premier League,ENG,Defender,"156,000",20,2,0,2
2466,Brentford,Premier League,UKR,Midfilder,"156,000",18,21,0,21
2467,Crystal Palace,Premier League,NIR,Defender,"156,000",21,115,0,115
2468,Tottenham,Premier League,ENG,Midfilder,"156,000",19,0,0,0
2469,Leicester,Premier League,ENG,Forward,"156,000",19,1,0,1
2470,Man City,Premier League,ENG,Midfilder,"156,000",19,3,0,3
2471,Man City,Premier League,POR,Forward,"156,000",18,1,0,1
2472,Aston Villa,Premier League,POL,Goalkeeper,"156,000",18,0,0,0
2473,Leicester,Premier League,RSA,Midfilder,"156,000",22,14,0,14
2474,Man City,Premier League,ENG,Goalkeeper,"156,000",18,0,0,0
2475,Man City,Premier League,ENG,Forward,"156,000",18,0,0,0
2476,Man City,Premier League,ENG,Midfilder,"156,000",18,0,0,0
2477,Wolves,Premier League,ENG,Midfilder,"156,000",18,0,0,0
2478,Man City,Premier League,SCO,Midfilder,"156,000",18,0,0,0
2479,Man City,Premier League,SCO,Forward,"156,000",18,1,0,1
2480,Man City,Premier League,ENG,Defender,"156,000",20,0,0,0
2481,Espanyol,La Liga,ESP,Goalkeeper,"155,000",21,21,0,21
2482,AC Ajaccio,Ligue 1 Uber Eats,FRA,Midfilder,"155,000",24,20,0,20
2483,A. Bilbao,La Liga,ESP,Forward,"153,000",25,224,0,224
2484,Vallecano,La Liga,ESP,Forward,"153,000",23,148,0,148
2485,Famalicao,Primiera Liga,PAN,Midfilder,"150,000",24,94,39,133
2486,Estoril Praia,Primiera Liga,MOZ,Defender,"150,000",33,353,58,411
2487,BVT,Primiera Liga,VEN,Forward,"150,000",25,119,20,139
2488,Getafe,La Liga,ESP,Forward,"150,000",21,55,0,55
2489,Rio Ave,Primiera Liga,BRA,Defender,"150,000",23,102,0,102
2490,Chaves,Primiera Liga,ESP,Forward,"150,000",20,65,0,65
2491,Girona,La Liga,URU,Defender,"149,000",23,114,0,114
2492,Real Hispalis,La Liga,ARG,Midfilder,"148,000",22,93,0,93
2493,Toulouse FC,Ligue 1 Uber Eats,ALG,Midfilder,"147,000",19,6,0,6
2494,Reims,Ligue 1 Uber Eats,SEN,Midfilder,"147,000",20,36,1,37
2495,Reims,Ligue 1 Uber Eats,MLI,Midfilder,"147,000",19,14,0,14
2496,Angers SCO,Ligue 1 Uber Eats,ALG,Midfilder,"147,000",25,83,3,86
2497,SV Werder,Bundesliga,GER,Defender,"147,000",22,91,0,91
2498,Angers SCO,Ligue 1 Uber Eats,FRA,Defender,"147,000",19,38,0,38
2499,Reims,Ligue 1 Uber Eats,FRA,Goalkeeper,"147,000",22,3,0,3
2500,Brianza,Serie A,ITA,Midfilder,"147,000",23,92,0,92
2501,VfL Bochum,Bundesliga,GAM,Defender,"146,000",26,149,6,155
2502,Santa Clara,Primiera Liga,BRA,Midfilder,"146,000",22,18,0,18
2503,Famalicao,Primiera Liga,BRA,Defender,"146,000",23,101,0,101
2504,BRG,Primiera Liga,POR,Goalkeeper,"146,000",27,163,0,163
2505,Toulouse FC,Ligue 1 Uber Eats,NED,Forward,"145,000",21,67,0,67
2506,Mallorca,La Liga,ESP,Goalkeeper,"144,000",22,57,0,57
2507,Arouca,Primiera Liga,POR,Defender,"144,000",27,232,0,232
2508,FC Lorient,Ligue 1 Uber Eats,CMR,Defender,"144,000",21,70,0,70
2509,Spezia,Serie A,LVA,Forward,"143,000",20,106,23,129
2510,P. Ferreira,Primiera Liga,POR,Defender,"143,000",35,341,13,354
2511,Clermont,Ligue 1 Uber Eats,FRA,Goalkeeper,"143,000",24,28,0,28
2512,RB Leipzig,Bundesliga,USA,Forward,"143,000",19,64,0,64
2513,P. Ferreira,Primiera Liga,ESP,Forward,"141,000",23,67,0,67
2514,BVT,Primiera Liga,BRA,Goalkeeper,"141,000",41,354,0,354
2515,Famalicao,Primiera Liga,POR,Defender,"141,000",23,92,0,92
2516,Famalicao,Primiera Liga,ESP,Defender,"141,000",26,142,0,142
2517,Famalicao,Primiera Liga,POR,Forward,"141,000",27,233,0,233
2518,Gil Vicente,Primiera Liga,ESP,Forward,"141,000",24,149,0,149
2519,Benfica,Primiera Liga,POR,Forward,"141,000",20,25,0,25
2520,MRT,Primiera Liga,POR,Midfilder,"141,000",24,135,0,135
2521,Rio Ave,Primiera Liga,BRA,Defender,"141,000",25,88,0,88
2522,Santa Clara,Primiera Liga,ESP,Defender,"141,000",26,136,0,136
2523,Rio Ave,Primiera Liga,POR,Midfilder,"141,000",25,113,0,113
2524,Famalicao,Primiera Liga,POR,Defender,"141,000",32,275,0,275
2525,Chaves,Primiera Liga,POR,Defender,"141,000",21,38,0,38
2526,Gil Vicente,Primiera Liga,ESP,Defender,"141,000",25,131,0,131
2527,Rio Ave,Primiera Liga,POR,Midfilder,"141,000",31,241,0,241
2528,VTSC,Primiera Liga,BRA,Forward,"141,000",24,140,0,140
2529,Estoril Praia,Primiera Liga,POR,Defender,"141,000",21,44,0,44
2530,AC Ajaccio,Ligue 1 Uber Eats,FRA,Defender,"141,000",22,31,0,31
2531,Hoffenheim,Bundesliga,GER,Goalkeeper,"140,000",21,47,0,47
2532,AJ Auxerre,Ligue 1 Uber Eats,FRA,Defender,"140,000",19,18,0,18
2533,Inter,Serie A,ITA,Defender,"140,000",19,1,0,1
2534,Santa Clara,Primiera Liga,BRA,Forward,"139,000",22,36,0,36
2535,Elche,La Liga,ESP,Midfilder,"139,000",25,210,0,210
2536,Vigo,La Liga,SWE,Midfilder,"138,000",18,58,0,58
2537,Atletico Pamplona,La Liga,ESP,Defender,"138,000",23,140,0,140
2538,Getafe,La Liga,ESP,Defender,"138,000",24,154,0,154
2539,Almeria,La Liga,ESP,Defender,"138,000",24,152,0,152
2540,Mallorca,La Liga,ESP,Midfilder,"138,000",24,197,0,197
2541,Getafe,La Liga,ESP,Midfilder,"138,000",23,88,0,88
2542,Vallecano,La Liga,ESP,Defender,"138,000",23,133,0,133
2543,Valencia,La Liga,GEO,Goalkeeper,"138,000",21,80,3,83
2544,Vallecano,La Liga,ESP,Defender,"138,000",23,77,0,77
2545,Girona,La Liga,ESP,Defender,"138,000",19,55,0,55
2546,Cadiz,La Liga,PAR,Defender,"138,000",24,117,21,138
2547,Elche,La Liga,ARG,Defender,"138,000",22,49,0,49
2548,Almeria,La Liga,SRB,Forward,"138,000",19,18,0,18
2549,Real San Sebastian,La Liga,ESP,Goalkeeper,"138,000",25,104,0,104
2550,Angers SCO,Ligue 1 Uber Eats,FRA,Forward,"137,000",22,17,0,17
2551,Famalicao,Primiera Liga,POR,Midfilder,"137,000",32,382,0,382
2552,Sampdoria,Serie A,SVN,Goalkeeper,"136,000",19,10,0,10
2553,Atletico Pamplona,La Liga,ESP,Defender,"136,000",30,258,0,258
2554,Montpellier,Ligue 1 Uber Eats,MLI,Defender,"135,000",27,177,28,205
2555,MRT,Primiera Liga,POR,Defender,"135,000",20,66,0,66
2556,VTSC,Primiera Liga,POR,Forward,"135,000",23,132,0,132
2557,Gil Vicente,Primiera Liga,IRN,Forward,"135,000",26,272,3,275
2558,Eintracht Frankfurt,Bundesliga,ALB,Goalkeeper,"134,000",18,28,0,28
2559,VfL Bochum,Bundesliga,GER,Midfilder,"134,000",21,69,0,69
2560,Cremonese,Serie A,ITA,Defender,"134,000",22,102,0,102
2561,Mallorca,La Liga,ESP,Forward,"134,000",29,323,0,323
2562,Gil Vicente,Primiera Liga,ESP,Midfilder,"134,000",21,58,0,58
2563,AC Ajaccio,Ligue 1 Uber Eats,FRA,Midfilder,"134,000",36,426,0,426
2564,SV Werder,Bundesliga,GER,Goalkeeper,"133,000",27,125,0,125
2565,Girona,La Liga,MLI,Midfilder,"133,000",22,51,0,51
2566,Cremonese,Serie A,ITA,Goalkeeper,"133,000",22,55,0,55
2567,VTSC,Primiera Liga,BRA,Forward,"132,000",27,165,0,165
2568,Famalicao,Primiera Liga,ESP,Midfilder,"132,000",21,102,0,102
2569,P. Ferreira,Primiera Liga,BRA,Midfilder,"132,000",37,348,0,348
2570,BVT,Primiera Liga,BRA,Goalkeeper,"132,000",30,42,0,42
2571,BVT,Primiera Liga,CUW,Forward,"132,000",27,127,10,137
2572,Santa Clara,Primiera Liga,BRA,Forward,"132,000",27,174,0,174
2573,Estoril Praia,Primiera Liga,POR,Defender,"132,000",22,56,0,56
2574,Famalicao,Primiera Liga,POR,Forward,"132,000",32,265,0,265
2575,Liverpool,Premier League,WAL,Defender,"130,000",20,5,0,5
2576,Liverpool,Premier League,ENG,Defender,"130,000",18,0,0,0
2577,Liverpool,Premier League,ENG,Midfilder,"130,000",19,2,0,2
2578,Liverpool,Premier League,ENG,Goalkeeper,"130,000",19,0,0,0
2579,Chelsea,Premier League,ENG,Goalkeeper,"130,000",18,0,0,0
2580,Liverpool,Premier League,ENG,Forward,"130,000",19,13,0,13
2581,Chelsea,Premier League,FIN,Midfilder,"130,000",18,0,0,0
2582,Liverpool,Premier League,ENG,Forward,"130,000",18,0,0,0
2583,Brentford,Premier League,ENG,Forward,"130,000",18,0,0,0
2584,Liverpool,Premier League,ENG,Forward,"130,000",18,0,0,0
2585,Liverpool,Premier League,ENG,Midfilder,"130,000",18,16,0,16
2586,Liverpool,Premier League,FRA,Defender,"130,000",19,9,0,9
2587,Leicester,Premier League,ENG,Forward,"130,000",19,0,0,0
2588,Tottenham,Premier League,ENG,Defender,"130,000",21,0,0,0
2589,Arsenal,Premier League,EST,Goalkeeper,"130,000",20,10,14,24
2590,Everton,Premier League,ENG,Forward,"130,000",21,62,0,62
2591,Chelsea,Premier League,USA,Goalkeeper,"130,000",20,23,0,23
2592,Liverpool,Premier League,ENG,Defender,"130,000",19,0,0,0
2593,Liverpool,Premier League,ENG,Midfilder,"130,000",19,0,0,0
2594,Newcastle,Premier League,PER,Midfilder,"130,000",23,63,0,63
2595,Liverpool,Premier League,USA,Midfilder,"130,000",20,0,0,0
2596,Man UFC,Premier League,FRA,Forward,"130,000",19,0,0,0
2597,Liverpool,Premier League,NGA,Defender,"130,000",21,0,0,0
2598,Fulham,Premier League,BUL,Forward,"130,000",20,38,0,38
2599,Southampton,Premier League,ENG,Defender,"130,000",22,26,0,26
2600,Brentford,Premier League,ENG,Defender,"130,000",19,0,0,0
2601,Brentford,Premier League,ENG,Midfilder,"130,000",19,2,0,2
2602,Valencia,La Liga,ESP,Defender,"130,000",18,9,0,9
2603,Leicester,Premier League,WAL,Midfilder,"130,000",19,0,0,0
2604,Fulham,Premier League,ENG,Goalkeeper,"130,000",20,40,0,40
2605,Chelsea,Premier League,FIN,Goalkeeper,"130,000",20,23,0,23
2606,Newcastle,Premier League,ENG,Defender,"130,000",19,0,0,0
2607,Newcastle,Premier League,ENG,Defender,"130,000",18,0,0,0
2608,Chelsea,Premier League,ENG,Forward,"130,000",19,16,0,16
2609,Liverpool,Premier League,POL,Goalkeeper,"130,000",19,31,0,31
2610,Brentford,Premier League,FRA,Defender,"130,000",20,5,0,5
2611,Chelsea,Premier League,ENG,Defender,"130,000",18,6,0,6
2612,Chelsea,Premier League,MAR,Goalkeeper,"130,000",18,5,0,5
2613,Aston Villa,Premier League,ENG,Defender,"130,000",20,5,0,5
2614,Chelsea,Premier League,ENG,Defender,"130,000",18,0,0,0
2615,Man UFC,Premier League,ENG,Defender,"130,000",19,6,0,6
2616,Wolves,Premier League,POR,Defender,"130,000",19,13,0,13
2617,Montpellier,Ligue 1 Uber Eats,CGO,Forward,"129,000",19,25,10,35
2618,Fiorentina,Serie A,ITA,Goalkeeper,"129,000",23,43,0,43
2619,MRT,Primiera Liga,BRA,Midfilder,"129,000",22,47,0,47
2620,OL,Ligue 1 Uber Eats,FRA,Midfilder,"128,000",18,6,0,6
2621,Valencia,La Liga,URU,Defender,"128,000",19,43,0,43
2622,Famalicao,Primiera Liga,ALB,Defender,"128,000",24,70,8,78
2623,VIZ,Primiera Liga,MLI,Forward,"128,000",25,88,1,89
2624,VIZ,Primiera Liga,POR,Defender,"128,000",26,154,0,154
2625,Estoril Praia,Primiera Liga,FRA,Midfilder,"128,000",24,110,0,110
2626,Salento,Serie A,ITA,Goalkeeper,"128,000",27,145,0,145
2627,Cremonese,Serie A,ITA,Defender,"128,000",25,134,0,134
2628,Angers SCO,Ligue 1 Uber Eats,BIH,Defender,"128,000",23,77,0,77
2629,Brest,Ligue 1 Uber Eats,FRA,Defender,"128,000",20,24,0,24
2630,Angers SCO,Ligue 1 Uber Eats,FRA,Midfilder,"128,000",20,11,0,11
2631,Almeria,La Liga,ESP,Goalkeeper,"127,000",32,404,0,404
2632,AC Ajaccio,Ligue 1 Uber Eats,GLP,Defender,"126,000",35,411,13,424
2633,P. Ferreira,Primiera Liga,BRA,Forward,"125,000",20,26,0,26
2634,Vigo,La Liga,ESP,Defender,"125,000",21,46,0,46
2635,VTSC,Primiera Liga,GHA,Midfilder,"124,000",28,104,0,104
2636,VTSC,Primiera Liga,FRA,Midfilder,"124,000",24,85,0,85
2637,BVT,Primiera Liga,MNE,Midfilder,"124,000",23,92,3,95
2638,Lazio,Serie A,ITA,Midfilder,"124,000",20,1,0,1
2639,VfL Bochum,Bundesliga,GER,Defender,"123,000",25,180,0,180
2640,Rio Ave,Primiera Liga,BRA,Goalkeeper,"123,000",31,123,0,123
2641,Chaves,Primiera Liga,SEN,Midfilder,"123,000",26,143,6,149
2642,MRT,Primiera Liga,POR,Defender,"123,000",21,39,0,39
2643,Benfica,Primiera Liga,POR,Goalkeeper,"123,000",20,12,0,12
2644,Toulouse FC,Ligue 1 Uber Eats,FRA,Defender,"123,000",21,48,0,48
2645,Benfica,Primiera Liga,ALB,Defender,"123,000",20,7,1,8
2646,VTSC,Primiera Liga,ITA,Defender,"123,000",20,40,0,40
2647,PTM,Primiera Liga,MAR,Defender,"123,000",26,122,0,122
2648,Chaves,Primiera Liga,ESP,Forward,"123,000",26,207,0,207
2649,Rio Ave,Primiera Liga,POR,Midfilder,"123,000",34,366,0,366
2650,MRT,Primiera Liga,GEO,Goalkeeper,"123,000",32,204,17,221
2651,Famalicao,Primiera Liga,RUS,Goalkeeper,"123,000",25,73,0,73
2652,Gil Vicente,Primiera Liga,POR,Midfilder,"123,000",34,415,0,415
2653,Gil Vicente,Primiera Liga,RUS,Goalkeeper,"123,000",31,202,2,204
2654,Rio Ave,Primiera Liga,GHA,Forward,"123,000",26,155,7,162
2655,VIZ,Primiera Liga,POR,Defender,"123,000",25,156,0,156
2656,VIZ,Primiera Liga,BRA,Midfilder,"123,000",34,402,0,402
2657,BVT,Primiera Liga,FRA,Defender,"123,000",31,225,0,225
2658,Chaves,Primiera Liga,CPV,Defender,"123,000",27,237,23,260
2659,AC Ajaccio,Ligue 1 Uber Eats,TUN,Forward,"122,000",35,332,6,338
2660,Sampdoria,Serie A,ITA,Midfilder,"120,000",19,3,0,3
2661,Cadiz,La Liga,MLI,Midfilder,"120,000",24,56,0,56
2662,LOSC,Ligue 1 Uber Eats,FRA,Midfilder,"119,000",19,46,0,46
2663,Chaves,Primiera Liga,BRA,Defender,"119,000",27,159,0,159
2664,PTM,Primiera Liga,BRA,Forward,"119,000",29,187,0,187
2665,BVT,Primiera Liga,GAM,Forward,"119,000",28,176,6,182
2666,VTSC,Primiera Liga,POR,Defender,"119,000",25,134,0,134
2667,Toulouse FC,Ligue 1 Uber Eats,NOR,Defender,"116,000",21,98,0,98
2668,Arsenal,Premier League,ENG,Midfilder,"114,000",21,81,0,81
2669,Empoli,Serie A,ITA,Midfilder,"114,000",19,0,0,0
2670,Reims,Ligue 1 Uber Eats,NOR,Forward,"113,000",21,37,0,37
2671,Benfica,Primiera Liga,POR,Defender,"113,000",20,33,0,33
2672,Gil Vicente,Primiera Liga,BRA,Midfilder,"113,000",27,147,0,147
2673,Hoffenheim,Bundesliga,ESP,Goalkeeper,"112,000",19,12,0,12
2674,Sporting CP,Primiera Liga,POR,Defender,"112,000",19,33,0,33
2675,Hertha Berlin,Bundesliga,GER,Forward,"112,000",22,25,0,25
2676,MRT,Primiera Liga,POR,Forward,"112,000",35,353,0,353
2677,Casa Pia,Primiera Liga,JPN,Forward,"112,000",24,158,0,158
2678,PTM,Primiera Liga,BRA,Midfilder,"112,000",28,182,0,182
2679,Gil Vicente,Primiera Liga,POR,Defender,"112,000",24,116,0,116
2680,Salento,Serie A,ALB,Defender,"112,000",30,258,13,271
2681,Casa Pia,Primiera Liga,NGA,Forward,"112,000",26,172,0,172
2682,VTSC,Primiera Liga,JPN,Defender,"112,000",25,186,5,191
2683,Espanyol,La Liga,BRA,Midfilder,"112,000",23,58,0,58
2684,Rio Ave,Primiera Liga,POR,Defender,"112,000",30,260,0,260
2685,Chaves,Primiera Liga,POR,Midfilder,"112,000",28,218,0,218
2686,Famalicao,Primiera Liga,POR,Defender,"112,000",20,34,0,34
2687,Rio Ave,Primiera Liga,GHA,Forward,"112,000",24,111,0,111
2688,BRG,Primiera Liga,ESP,Midfilder,"112,000",23,48,0,48
2689,Famalicao,Primiera Liga,ROU,Midfilder,"112,000",24,91,0,91
2690,Chaves,Primiera Liga,GHA,Midfilder,"112,000",23,95,0,95
2691,Toulouse FC,Ligue 1 Uber Eats,NED,Forward,"112,000",22,56,0,56
2692,MRT,Primiera Liga,BRA,Defender,"112,000",27,125,0,125
2693,MRT,Primiera Liga,BRA,Defender,"112,000",30,233,0,233
2694,MRT,Primiera Liga,POR,Defender,"112,000",31,272,0,272
2695,VIZ,Primiera Liga,BRA,Defender,"112,000",28,140,0,140
2696,Famalicao,Primiera Liga,POR,Midfilder,"112,000",23,60,0,60
2697,Estoril Praia,Primiera Liga,BRA,Defender,"112,000",27,75,0,75
2698,Rio Ave,Primiera Liga,COL,Forward,"112,000",26,162,0,162
2699,AC Ajaccio,Ligue 1 Uber Eats,FRA,Forward,"112,000",31,277,0,277
2700,MRT,Primiera Liga,BRA,Defender,"112,000",28,133,0,133
2701,Hertha Berlin,Bundesliga,GER,Forward,"112,000",19,36,0,36
2702,VIZ,Primiera Liga,MNE,Forward,"112,000",23,106,12,118
2703,Elche,La Liga,ARG,Defender,"111,000",23,84,0,84
2704,Famalicao,Primiera Liga,FRA,Forward,"111,000",19,4,0,4
2705,Sporting CP,Primiera Liga,POR,Forward,"110,000",20,2,0,2
2706,Sporting CP,Primiera Liga,POR,Goalkeeper,"110,000",25,74,0,74
2707,Rio Ave,Primiera Liga,POR,Forward,"110,000",34,316,1,317
2708,Gil Vicente,Primiera Liga,JPN,Midfilder,"110,000",23,116,0,116
2709,Estoril Praia,Primiera Liga,POR,Goalkeeper,"110,000",24,107,0,107
2710,Casa Pia,Primiera Liga,CMR,Defender,"107,000",24,60,1,61
2711,Toulouse FC,Ligue 1 Uber Eats,CPV,Defender,"106,000",21,30,3,33
2712,Mallorca,La Liga,COL,Forward,"106,000",19,42,0,42
2713,VIZ,Primiera Liga,IRQ,Midfilder,"105,000",30,205,20,225
2714,P. Ferreira,Primiera Liga,CHI,Defender,"105,000",29,254,9,263
2715,Casa Pia,Primiera Liga,BRA,Forward,"105,000",33,300,0,300
2716,MRT,Primiera Liga,POR,Forward,"105,000",24,132,0,132
2717,Famalicao,Primiera Liga,POR,Forward,"105,000",19,32,0,32
2718,Rio Ave,Primiera Liga,POR,Defender,"105,000",22,47,0,47
2719,Santa Clara,Primiera Liga,POR,Defender,"105,000",25,152,0,152
2720,Santa Clara,Primiera Liga,POR,Forward,"105,000",30,266,0,266
2721,Casa Pia,Primiera Liga,POR,Defender,"105,000",26,190,0,190
2722,Santa Clara,Primiera Liga,ARG,Goalkeeper,"105,000",36,218,0,218
2723,VIZ,Primiera Liga,POR,Forward,"105,000",26,270,0,270
2724,VTSC,Primiera Liga,POR,Defender,"105,000",20,52,0,52
2725,Brighton,Premier League,ENG,Midfilder,"104,000",19,0,0,0
2726,Everton,Premier League,ENG,Goalkeeper,"104,000",22,32,0,32
2727,Man UFC,Premier League,ENG,Midfilder,"104,000",35,468,4,472
2728,Brentford,Premier League,IRL,Forward,"104,000",20,12,0,12
2729,Aston Villa,Premier League,ENG,Midfilder,"104,000",18,1,0,1
2730,Brentford,Premier League,IRL,Defender,"104,000",20,7,0,7
2731,Leeds,Premier League,ENG,Forward,"104,000",18,5,0,5
2732,West Ham,Premier League,ENG,Midfilder,"104,000",20,1,0,1
2733,Leicester,Premier League,GUY,Defender,"104,000",21,8,2,10
2734,Liverpool,Premier League,POL,Goalkeeper,"104,000",18,0,0,0
2735,Man UFC,Premier League,ENG,Midfilder,"104,000",18,0,0,0
2736,Brighton,Premier League,IRL,Midfilder,"104,000",19,2,0,2
2737,Tottenham,Premier League,ENG,Midfilder,"104,000",19,0,0,0
2738,Tottenham,Premier League,ENG,Forward,"104,000",19,0,0,0
2739,Brighton,Premier League,ENG,Goalkeeper,"104,000",19,25,0,25
2740,Estoril Praia,Primiera Liga,CRC,Midfilder,"104,000",19,64,8,72
2741,Brighton,Premier League,AUS,Forward,"104,000",19,1,0,1
2742,Brighton,Premier League,ENG,Forward,"104,000",18,0,0,0
2743,Tottenham,Premier League,ENG,Goalkeeper,"104,000",23,19,0,19
2744,Leeds,Premier League,ENG,Forward,"104,000",19,1,0,1
2745,Brighton,Premier League,ENG,Defender,"104,000",19,1,0,1
2746,Arsenal,Premier League,NOR,Forward,"104,000",22,40,0,40
2747,FC Augsburg,Bundesliga,ITA,Forward,"104,000",22,119,0,119
2748,Everton,Premier League,ENG,Defender,"104,000",18,0,0,0
2749,Brighton,Premier League,IRL,Forward,"104,000",18,5,0,5
2750,Brighton,Premier League,SWE,Defender,"104,000",18,0,0,0
2751,Brentford,Premier League,SCO,Goalkeeper,"104,000",18,0,0,0
2752,Brighton,Premier League,ENG,Defender,"104,000",19,0,0,0
2753,Liverpool,Premier League,ENG,Midfilder,"104,000",33,394,0,394
2754,Leicester,Premier League,WAL,Defender,"104,000",19,0,0,0
2755,Fulham,Premier League,AUS,Midfilder,"104,000",22,16,0,16
2756,Man UFC,Premier League,IRQ,Midfilder,"104,000",19,1,2,3
2757,Leeds,Premier League,NED,Goalkeeper,"104,000",19,0,0,0
2758,Brighton,Premier League,ENG,Goalkeeper,"104,000",19,20,0,20
2759,AJ Auxerre,Ligue 1 Uber Eats,FRA,Forward,"103,000",36,396,0,396
2760,Brest,Ligue 1 Uber Eats,FRA,Midfilder,"103,000",24,104,0,104
2761,Mainz 05,Bundesliga,GER,Defender,"103,000",22,56,0,56
2762,VfL Wolfsburg,Bundesliga,GER,Defender,"103,000",18,0,0,0
2763,FC Nantes,Ligue 1 Uber Eats,FRA,Defender,"101,000",19,40,0,40
2764,PTM,Primiera Liga,HON,Forward,"101,000",27,225,18,243
2765,BVT,Primiera Liga,POR,Midfilder,"101,000",24,80,0,80
2766,VIZ,Primiera Liga,BRA,Defender,"101,000",27,116,0,116
2767,Santa Clara,Primiera Liga,BRA,Defender,"101,000",27,105,0,105
2768,Santa Clara,Primiera Liga,JPN,Defender,"101,000",26,220,6,226
2769,Chaves,Primiera Liga,BRA,Forward,"101,000",25,137,0,137
2770,Benfica,Primiera Liga,JPN,Goalkeeper,"101,000",21,9,0,9
2771,Estoril Praia,Primiera Liga,POR,Defender,"101,000",20,4,0,4
2772,VIZ,Primiera Liga,POR,Midfilder,"101,000",26,151,0,151
2773,PTM,Primiera Liga,POR,Defender,"101,000",22,25,0,25
2774,Salento,Serie A,BRA,Midfilder,"99,500",25,158,0,158
2775,Strasbourg,Ligue 1 Uber Eats,FRA,Defender,"99,000",19,29,0,29
2776,Torino,Serie A,FRA,Defender,"96,500",22,49,0,49
2777,Torino,Serie A,LTU,Midfilder,"96,500",18,31,0,31
2778,BRG,Primiera Liga,POR,Forward,"96,500",19,31,0,31
2779,Casa Pia,Primiera Liga,CPV,Defender,"96,500",34,394,49,443
2780,VTSC,Primiera Liga,POR,Midfilder,"96,500",21,48,0,48
2781,P. Ferreira,Primiera Liga,BRA,Defender,"96,500",28,116,0,116
2782,Chaves,Primiera Liga,CPV,Defender,"96,500",26,173,2,175
2783,P. Ferreira,Primiera Liga,POR,Midfilder,"96,500",24,125,0,125
2784,Benfica,Primiera Liga,POR,Defender,"96,500",18,0,0,0
2785,Valencia,La Liga,ESP,Midfilder,"96,000",23,90,0,90
2786,Sampdoria,Serie A,ITA,Defender,"95,000",21,51,0,51
2787,Sassuolo,Serie A,ITA,Goalkeeper,"95,000",21,22,0,22
2788,Cremonese,Serie A,ITA,Defender,"95,000",23,180,0,180
2789,Sampdoria,Serie A,MAR,Midfilder,"95,000",25,137,0,137
2790,BVT,Primiera Liga,POR,Forward,"94,000",30,297,0,297
2791,Arouca,Primiera Liga,PLE,Forward,"93,500",23,52,27,79
2792,AC Ajaccio,Ligue 1 Uber Eats,COM,Defender,"93,000",30,130,32,162
2793,OM,Ligue 1 Uber Eats,ESP,Forward,"92,500",22,30,0,30
2794,Arouca,Primiera Liga,ARG,Forward,"92,000",29,213,0,213
2795,Arouca,Primiera Liga,ESP,Defender,"92,000",23,101,0,101
2796,Arouca,Primiera Liga,URU,Goalkeeper,"92,000",25,139,0,139
2797,Arouca,Primiera Liga,POR,Midfilder,"91,500",32,293,0,293
2798,Spezia,Serie A,SVN,Midfilder,"90,500",19,42,0,42
2799,Brianza,Serie A,ITA,Goalkeeper,"90,500",20,26,0,26
2800,Montpellier,Ligue 1 Uber Eats,FRA,Midfilder,"89,500",18,3,0,3
2801,SC Freiburg,Bundesliga,GER,Midfilder,"89,500",19,32,0,32
2802,PSG,Ligue 1 Uber Eats,ESP,Forward,"88,000",18,7,0,7
2803,Brianza,Serie A,ITA,Goalkeeper,"87,500",33,318,0,318
2804,MRT,Primiera Liga,PER,Forward,"87,500",22,51,0,51
2805,Casa Pia,Primiera Liga,POR,Defender,"87,500",22,95,0,95
2806,BVT,Primiera Liga,URU,Defender,"87,500",28,141,0,141
2807,P. Ferreira,Primiera Liga,BRA,Defender,"87,500",28,148,0,148
2808,Gil Vicente,Primiera Liga,GEO,Midfilder,"87,500",27,205,34,239
2809,Gil Vicente,Primiera Liga,BRA,Midfilder,"87,500",25,113,0,113
2810,Estoril Praia,Primiera Liga,BRA,Forward,"87,500",33,237,0,237
2811,VIZ,Primiera Liga,BRA,Goalkeeper,"87,500",25,55,0,55
2812,P. Ferreira,Primiera Liga,POR,Goalkeeper,"87,500",35,326,1,327
2813,VIZ,Primiera Liga,POR,Midfilder,"87,500",27,185,0,185
2814,Estoril Praia,Primiera Liga,POR,Midfilder,"87,500",23,128,0,128
2815,BRG,Primiera Liga,FRA,Midfilder,"87,500",20,14,0,14
2816,VIZ,Primiera Liga,AUT,Forward,"87,500",24,107,0,107
2817,VTSC,Primiera Liga,ANG,Forward,"87,500",24,126,11,137
2818,PTM,Primiera Liga,POR,Midfilder,"87,500",23,20,0,20
2819,Benfica,Primiera Liga,POR,Midfilder,"87,500",22,25,0,25
2820,Casa Pia,Primiera Liga,POR,Midfilder,"87,500",30,259,0,259
2821,Arouca,Primiera Liga,BRA,Defender,"87,500",25,130,0,130
2822,PTM,Primiera Liga,JPN,Goalkeeper,"87,500",27,160,6,166
2823,Atletico Pamplona,La Liga,ESP,Forward,"87,000",23,65,0,65
2824,Schalke 04,Bundesliga,GER,Midfilder,"86,000",18,0,0,0
2825,Schalke 04,Bundesliga,GER,Forward,"86,000",18,1,0,1
2826,VfL Wolfsburg,Bundesliga,GER,Forward,"86,000",18,0,0,0
2827,VfL Wolfsburg,Bundesliga,POR,Forward,"86,000",18,0,0,0
2828,VfL Bochum,Bundesliga,GER,Goalkeeper,"86,000",21,0,0,0
2829,FC Bayern,Bundesliga,KOS,Midfilder,"86,000",18,0,0,0
2830,VfL Wolfsburg,Bundesliga,GER,Defender,"86,000",18,0,0,0
2831,Spezia,Serie A,BIH,Goalkeeper,"86,000",20,1,0,1
2832,Fiorentina,Serie A,ITA,Midfilder,"86,000",18,26,0,26
2833,AC Ajaccio,Ligue 1 Uber Eats,COM,Defender,"84,500",34,295,37,332
2834,Milan,Serie A,ROU,Defender,"83,000",18,0,0,0
2835,PTM,Primiera Liga,BRA,Midfilder,"83,000",33,371,0,371
2836,P. Ferreira,Primiera Liga,POR,Defender,"83,000",22,37,0,37
2837,Arouca,Primiera Liga,UKR,Defender,"83,000",24,134,0,134
2838,Casa Pia,Primiera Liga,ANG,Goalkeeper,"83,000",35,160,0,160
2839,P. Ferreira,Primiera Liga,GNB,Forward,"83,000",21,36,0,36
2840,Estoril Praia,Primiera Liga,SEN,Midfilder,"83,000",21,86,0,86
2841,Casa Pia,Primiera Liga,BRA,Forward,"83,000",23,111,0,111
2842,Santa Clara,Primiera Liga,FRA,Defender,"83,000",32,236,0,236
2843,Estoril Praia,Primiera Liga,POR,Defender,"83,000",21,25,0,25
2844,MRT,Primiera Liga,ITA,Midfilder,"83,000",29,219,0,219
2845,Benfica,Primiera Liga,POR,Defender,"83,000",20,19,0,19
2846,Gil Vicente,Primiera Liga,BRA,Forward,"83,000",24,66,0,66
2847,Arouca,Primiera Liga,ESP,Forward,"83,000",23,124,0,124
2848,MRT,Primiera Liga,BRA,Midfilder,"83,000",25,102,0,102
2849,Santa Clara,Primiera Liga,JPN,Forward,"83,000",23,128,2,130
2850,Chaves,Primiera Liga,POR,Midfilder,"83,000",29,280,0,280
2851,Gil Vicente,Primiera Liga,BRA,Goalkeeper,"83,000",21,10,0,10
2852,VIZ,Primiera Liga,CRO,Goalkeeper,"83,000",25,173,0,173
2853,Chaves,Primiera Liga,BRA,Goalkeeper,"83,000",33,160,0,160
2854,MRT,Primiera Liga,POR,Defender,"83,000",30,216,0,216
2855,Salernitana,Serie A,ITA,Midfilder,"81,000",19,0,0,0
2856,Estoril Praia,Primiera Liga,FRA,Defender,"80,500",23,76,0,76
2857,Arouca,Primiera Liga,POR,Midfilder,"80,500",33,304,0,304
2858,Union Berlin,Bundesliga,USA,Forward,"80,000",18,0,0,0
2859,BVT,Primiera Liga,GUI,Midfilder,"78,500",23,78,6,84
2860,Benfica,Primiera Liga,POR,Midfilder,"78,500",18,1,0,1
2861,PTM,Primiera Liga,BRA,Defender,"78,500",25,71,0,71
2862,VTSC,Primiera Liga,BRA,Midfilder,"78,500",23,69,0,69
2863,Chaves,Primiera Liga,NGA,Midfilder,"78,500",31,178,10,188
2864,FC Porto,Primiera Liga,POR,Defender,"78,500",18,0,0,0
2865,Chaves,Primiera Liga,CAN,Defender,"78,500",35,281,32,313
2866,VIZ,Primiera Liga,POR,Midfilder,"78,500",23,60,0,60
2867,Santa Clara,Primiera Liga,TOG,Defender,"78,500",25,164,4,168
2868,Casa Pia,Primiera Liga,POR,Defender,"78,500",35,387,0,387
2869,PTM,Primiera Liga,BRA,Defender,"78,500",23,37,0,37
2870,Famalicao,Primiera Liga,BRA,Forward,"78,500",18,5,0,5
2871,P. Ferreira,Primiera Liga,POR,Midfilder,"78,500",19,31,0,31
2872,Benfica,Primiera Liga,POR,Forward,"78,500",19,7,0,7
2873,Casa Pia,Primiera Liga,CPV,Midfilder,"78,500",34,204,13,217
2874,Gil Vicente,Primiera Liga,POR,Defender,"78,500",36,479,0,479
2875,Sporting CP,Primiera Liga,CAN,Forward,"78,500",19,16,0,16
2876,Rio Ave,Primiera Liga,BRA,Defender,"78,500",27,126,0,126
2877,Arouca,Primiera Liga,POR,Midfilder,"78,500",33,390,0,390
2878,Benfica,Primiera Liga,BUL,Defender,"78,500",18,0,0,0
2879,Benfica,Primiera Liga,POR,Defender,"78,500",19,0,0,0
2880,Casa Pia,Primiera Liga,BRA,Midfilder,"78,500",31,231,0,231
2881,Arsenal,Premier League,ENG,Goalkeeper,"78,000",21,8,0,8
2882,Brentford,Premier League,ENG,Defender,"78,000",20,0,0,0
2883,Leicester,Premier League,ENG,Goalkeeper,"78,000",20,8,0,8
2884,Leeds,Premier League,ENG,Forward,"78,000",19,5,0,5
2885,Everton,Premier League,ENG,Midfilder,"78,000",20,3,0,3
2886,Wolves,Premier League,ENG,Defender,"78,000",18,26,0,26
2887,Arsenal,Premier League,WAL,Defender,"78,000",18,4,0,4
2888,Arsenal,Premier League,ENG,Forward,"78,000",18,0,0,0
2889,Arsenal,Premier League,ENG,Defender,"78,000",18,1,0,1
2890,Brentford,Premier League,ENG,Midfilder,"78,000",18,0,0,0
2891,Brentford,Premier League,ENG,Midfilder,"78,000",18,0,0,0
2892,Man UFC,Premier League,FRA,Defender,"78,000",18,0,0,0
2893,Leicester,Premier League,THA,Midfilder,"78,000",22,0,9,9
2894,Arsenal,Premier League,POR,Midfilder,"78,000",18,0,0,0
2895,Everton,Premier League,SCO,Midfilder,"78,000",18,0,0,0
2896,Everton,Premier League,ENG,Forward,"78,000",18,5,0,5
2897,Brentford,Premier League,IRL,Defender,"78,000",19,7,0,7
2898,Everton,Premier League,NOR,Midfilder,"78,000",21,5,0,5
2899,Nottm Forest,Premier League,ENG,Defender,"78,000",18,0,0,0
2900,Aston Villa,Premier League,NED,Defender,"78,000",18,1,0,1
2901,Southampton,Premier League,ENG,Defender,"78,000",33,293,0,293
2902,Tottenham,Premier League,ENG,Goalkeeper,"78,000",23,34,0,34
2903,Tottenham,Premier League,ENG,Midfilder,"78,000",21,24,0,24
2904,Chelsea,Premier League,ENG,Defender,"78,000",18,0,0,0
2905,Crystal Palace,Premier League,ENG,Defender,"78,000",21,17,0,17
2906,Brentford,Premier League,ENG,Goalkeeper,"78,000",20,11,0,11
2907,Newcastle,Premier League,ENG,Defender,"78,000",20,0,0,0
2908,West Ham,Premier League,ENG,Midfilder,"78,000",20,16,0,16
2909,Wolves,Premier League,ENG,Defender,"78,000",20,17,0,17
2910,Brentford,Premier League,ENG,Forward,"78,000",20,9,0,9
2911,Leicester,Premier League,IRL,Defender,"78,000",20,0,0,0
2912,Brentford,Premier League,ENG,Forward,"78,000",18,0,0,0
2913,Leicester,Premier League,NED,Defender,"78,000",19,0,0,0
2914,Aston Villa,Premier League,ENG,Midfilder,"78,000",19,12,0,12
2915,Aston Villa,Premier League,ENG,Forward,"78,000",19,30,0,30
2916,Leicester,Premier League,IRL,Midfilder,"78,000",19,0,0,0
2917,Leicester,Premier League,POR,Midfilder,"78,000",19,1,0,1
2918,Brentford,Premier League,ENG,Forward,"78,000",19,13,0,13
2919,Leeds,Premier League,ESP,Forward,"78,000",18,1,0,1
2920,Tottenham,Premier League,ENG,Defender,"78,000",19,0,0,0
2921,Aston Villa,Premier League,ENG,Defender,"78,000",20,1,0,1
2922,Newcastle,Premier League,ENG,Forward,"78,000",19,0,0,0
2923,Brentford,Premier League,ALB,Midfilder,"78,000",22,23,0,23
2924,Brentford,Premier League,ENG,Goalkeeper,"78,000",21,0,0,0
2925,Arsenal,Premier League,ENG,Midfilder,"78,000",20,0,0,0
2926,Schalke 04,Bundesliga,GER,Defender,"77,500",18,0,0,0
2927,Inter,Serie A,ITA,Defender,"76,500",19,0,0,0
2928,Brest,Ligue 1 Uber Eats,ENG,Midfilder,"76,500",19,18,0,18
2929,Union Berlin,Bundesliga,GER,Midfilder,"75,500",21,30,0,30
2930,Toulouse FC,Ligue 1 Uber Eats,FRA,Defender,"75,500",21,45,0,45
2931,Santa Clara,Primiera Liga,BRA,Goalkeeper,"75,000",24,18,0,18
2932,Arouca,Primiera Liga,GUI,Midfilder,"74,000",24,52,12,64
2933,Estoril Praia,Primiera Liga,POR,Goalkeeper,"74,000",25,107,0,107
2934,PTM,Primiera Liga,BRA,Midfilder,"74,000",24,63,0,63
2935,FC Porto,Primiera Liga,POR,Midfilder,"74,000",20,46,0,46
2936,VTSC,Primiera Liga,POR,Defender,"74,000",21,29,0,29
2937,Gil Vicente,Primiera Liga,URU,Forward,"74,000",22,97,0,97
2938,MRT,Primiera Liga,POR,Midfilder,"74,000",24,104,0,104
2939,PTM,Primiera Liga,POR,Midfilder,"74,000",20,12,0,12
2940,Arouca,Primiera Liga,ENG,Defender,"74,000",23,79,0,79
2941,Rio Ave,Primiera Liga,POR,Defender,"74,000",22,51,0,51
2942,Benfica,Primiera Liga,GNB,Forward,"74,000",18,0,0,0
2943,VIZ,Primiera Liga,BRA,Defender,"74,000",21,55,0,55
2944,Casa Pia,Primiera Liga,POR,Forward,"74,000",23,56,0,56
2945,BVT,Primiera Liga,JPN,Midfilder,"74,000",23,113,0,113
2946,Arouca,Primiera Liga,BRA,Midfilder,"74,000",22,27,0,27
2947,Bayer 04,Bundesliga,MAR,Midfilder,"73,000",21,50,0,50
2948,Capitoline,Serie A,ITA,Forward,"73,000",18,6,0,6
2949,Man UFC,Premier League,NOR,Midfilder,"73,000",18,18,0,18
2950,West Ham,Premier League,ENG,Goalkeeper,"73,000",22,37,0,37
2951,Everton,Premier League,NIR,Forward,"73,000",19,3,0,3
2952,P. Ferreira,Primiera Liga,BRA,Defender,"71,500",30,183,0,183
2953,Bologna,Serie A,BEL,Forward,"71,500",18,2,0,2
2954,VTSC,Primiera Liga,POR,Defender,"71,500",19,35,0,35
2955,Milan,Serie A,SWE,Forward,"71,000",19,10,0,10
2956,MRT,Primiera Liga,BRA,Defender,"69,500",27,130,0,130
2957,BVT,Primiera Liga,POR,Defender,"69,500",31,281,0,281
2958,Chaves,Primiera Liga,POR,Midfilder,"69,500",26,205,0,205
2959,Arouca,Primiera Liga,CRO,Defender,"69,500",30,245,0,245
2960,AJ Auxerre,Ligue 1 Uber Eats,MAD,Defender,"69,000",26,114,0,114
2961,Strasbourg,Ligue 1 Uber Eats,FRA,Midfilder,"69,000",18,7,0,7
2962,Borussia M'gladbach,Bundesliga,GER,Forward,"68,500",18,0,0,0
2963,VfL Wolfsburg,Bundesliga,GER,Midfilder,"68,500",18,0,0,0
2964,VfL Wolfsburg,Bundesliga,GER,Defender,"68,500",18,0,0,0
2965,Borussia M'gladbach,Bundesliga,EGY,Midfilder,"68,500",18,0,0,0
2966,Borussia M'gladbach,Bundesliga,MKD,Midfilder,"68,500",18,0,0,0
2967,Borussia M'gladbach,Bundesliga,GER,Defender,"68,500",18,0,0,0
2968,Bayer 04,Bundesliga,GER,Defender,"68,500",19,1,0,1
2969,Schalke 04,Bundesliga,GER,Midfilder,"68,500",18,0,0,0
2970,Schalke 04,Bundesliga,GER,Defender,"68,500",18,0,0,0
2971,Schalke 04,Bundesliga,GER,Defender,"68,500",18,0,0,0
2972,Santa Clara,Primiera Liga,BRA,Midfilder,"67,000",22,67,0,67
2973,Rio Ave,Primiera Liga,FRA,Midfilder,"67,000",29,227,0,227
2974,PTM,Primiera Liga,BRA,Midfilder,"67,000",21,46,0,46
2975,SC Freiburg,Bundesliga,GER,Defender,"67,000",22,54,0,54
2976,MRT,Primiera Liga,COL,Defender,"67,000",21,38,0,38
2977,SC Freiburg,Bundesliga,GER,Defender,"67,000",20,51,0,51
2978,Estoril Praia,Primiera Liga,BRA,Forward,"67,000",27,120,0,120
2979,Gil Vicente,Primiera Liga,ANG,Forward,"67,000",22,57,1,58
2980,P. Ferreira,Primiera Liga,ECU,Defender,"67,000",23,28,1,29
2981,BRG,Primiera Liga,POR,Forward,"67,000",21,7,0,7
2982,Casa Pia,Primiera Liga,ANG,Midfilder,"67,000",20,49,0,49
2983,VIZ,Primiera Liga,POR,Defender,"67,000",27,176,0,176
2984,Empoli,Serie A,POR,Forward,"67,000",18,40,0,40
2985,Gil Vicente,Primiera Liga,FRA,Forward,"67,000",28,216,0,216
2986,Rio Ave,Primiera Liga,POR,Midfilder,"67,000",26,180,0,180
2987,P. Ferreira,Primiera Liga,POR,Defender,"67,000",25,130,0,130
2988,PTM,Primiera Liga,FRA,Midfilder,"67,000",26,111,0,111
2989,Udinese,Serie A,IRL,Defender,"67,000",18,24,0,24
2990,VIZ,Primiera Liga,USA,Midfilder,"67,000",21,79,0,79
2991,VIZ,Primiera Liga,POR,Defender,"67,000",22,50,0,50
2992,VTSC,Primiera Liga,POR,Goalkeeper,"67,000",22,41,0,41
2993,Santa Clara,Primiera Liga,POR,Midfilder,"67,000",25,196,0,196
2994,P. Ferreira,Primiera Liga,NED,Midfilder,"67,000",21,60,0,60
2995,VTSC,Primiera Liga,POR,Defender,"67,000",28,255,0,255
2996,PTM,Primiera Liga,POR,Defender,"67,000",22,54,0,54
2997,PTM,Primiera Liga,BRA,Goalkeeper,"67,000",24,23,0,23
2998,Cadiz,La Liga,ESP,Defender,"67,000",22,111,0,111
2999,Salento,Serie A,ITA,Goalkeeper,"66,500",21,1,0,1
3000,FC Porto,Primiera Liga,POR,Goalkeeper,"65,500",18,0,0,0
3001,PTM,Primiera Liga,POR,Forward,"65,500",25,123,0,123
3002,BVT,Primiera Liga,POR,Midfilder,"65,500",23,38,0,38
3003,Sporting CP,Primiera Liga,POR,Midfilder,"65,500",18,0,0,0
3004,P. Ferreira,Primiera Liga,POR,Defender,"65,500",26,173,0,173
3005,Sporting CP,Primiera Liga,POR,Defender,"65,500",19,19,0,19
3006,Casa Pia,Primiera Liga,POR,Forward,"65,000",24,106,0,106
3007,Casa Pia,Primiera Liga,BRA,Defender,"65,000",24,79,0,79
3008,P. Ferreira,Primiera Liga,SCO,Midfilder,"65,000",22,78,0,78
3009,Famalicao,Primiera Liga,AUS,Midfilder,"65,000",20,42,0,42
3010,Chaves,Primiera Liga,MOZ,Defender,"65,000",24,115,11,126
3011,P. Ferreira,Primiera Liga,POR,Forward,"65,000",28,213,0,213
3012,BRG,Primiera Liga,POR,Forward,"65,000",21,35,0,35
3013,Santa Clara,Primiera Liga,POR,Goalkeeper,"65,000",35,363,0,363
3014,Estoril Praia,Primiera Liga,NGA,Forward,"65,000",21,77,0,77
3015,Tottenham,Premier League,ENG,Defender,"65,000",18,6,0,6
3016,Benfica,Primiera Liga,CPV,Forward,"65,000",20,2,7,9
3017,Santa Clara,Primiera Liga,POR,Forward,"65,000",24,129,0,129
3018,Chaves,Primiera Liga,POR,Midfilder,"65,000",27,187,0,187
3019,Man UFC,Premier League,ARG,Forward,"65,000",18,7,0,7
3020,Sporting CP,Primiera Liga,POR,Defender,"65,000",18,1,0,1
3021,Famalicao,Primiera Liga,POR,Forward,"65,000",22,49,0,49
3022,PTM,Primiera Liga,SEN,Defender,"65,000",26,107,0,107
3023,VfL Wolfsburg,Bundesliga,GER,Goalkeeper,"64,500",18,0,0,0
3024,VfL Wolfsburg,Bundesliga,GER,Midfilder,"64,500",18,0,0,0
3025,Bologna,Serie A,ITA,Forward,"64,000",18,4,0,4
3026,Casa Pia,Primiera Liga,BRA,Forward,"63,000",23,52,0,52
3027,Sporting CP,Primiera Liga,POR,Forward,"63,000",19,0,0,0
3028,PTM,Primiera Liga,BRA,Defender,"62,500",30,180,0,180
3029,PTM,Primiera Liga,POR,Midfilder,"62,500",28,277,0,277
3030,Chaves,Primiera Liga,POR,Forward,"62,500",22,22,0,22
3031,Chaves,Primiera Liga,BRA,Forward,"62,500",27,80,0,80
3032,Santa Clara,Primiera Liga,POR,Forward,"62,500",25,162,0,162
3033,PTM,Primiera Liga,BRA,Forward,"62,500",24,83,0,83
3034,Man UFC,Premier League,ENG,Midfilder,"62,500",18,0,0,0
3035,Man UFC,Premier League,ESP,Defender,"62,500",18,0,0,0
3036,Man UFC,Premier League,NED,Defender,"62,500",19,0,0,0
3037,Crystal Palace,Premier League,IRL,Defender,"62,500",18,0,0,0
3038,Everton,Premier League,ENG,Goalkeeper,"62,500",20,0,0,0
3039,Strasbourg,Ligue 1 Uber Eats,JPN,Forward,"61,500",20,88,0,88
3040,Gil Vicente,Primiera Liga,BRA,Defender,"61,000",23,41,0,41
3041,BVT,Primiera Liga,NGA,Defender,"60,500",23,46,0,46
3042,Santa Clara,Primiera Liga,BRA,Defender,"60,500",20,6,0,6
3043,VTSC,Primiera Liga,POR,Defender,"60,500",20,56,0,56
3044,Casa Pia,Primiera Liga,BIH,Defender,"60,500",29,224,0,224
3045,Famalicao,Primiera Liga,POR,Defender,"60,500",21,3,0,3
3046,Casa Pia,Primiera Liga,BRA,Defender,"60,500",29,237,0,237
3047,Sporting CP,Primiera Liga,GAM,Midfilder,"60,500",20,1,0,1
3048,Rio Ave,Primiera Liga,POR,Midfilder,"60,500",27,179,0,179
3049,Sampdoria,Serie A,ITA,Forward,"60,500",24,131,0,131
3050,Cremonese,Serie A,POL,Goalkeeper,"60,500",21,22,0,22
3051,Atalanta,Serie A,ITA,Defender,"60,500",20,20,0,20
3052,Brianza,Serie A,EQG,Midfilder,"60,500",26,140,20,160
3053,Cremonese,Serie A,GHA,Forward,"60,000",19,17,6,23
3054,Parthenope,Serie A,ITA,Goalkeeper,"59,000",22,73,0,73
3055,Sporting CP,Primiera Liga,POR,Defender,"58,500",18,0,0,0
3056,Sporting CP,Primiera Liga,POR,Defender,"58,500",18,0,0,0
3057,Benfica,Primiera Liga,POR,Midfilder,"58,500",18,11,0,11
3058,P. Ferreira,Primiera Liga,POR,Defender,"58,500",26,117,0,117
3059,Gil Vicente,Primiera Liga,POR,Defender,"58,500",26,143,0,143
3060,Benfica,Primiera Liga,POR,Defender,"58,500",19,1,0,1
3061,Sporting CP,Primiera Liga,POR,Defender,"58,500",19,0,0,0
3062,Benfica,Primiera Liga,POR,Forward,"58,500",18,0,0,0
3063,Sporting CP,Primiera Liga,POR,Defender,"58,500",18,0,0,0
3064,Bologna,Serie A,FIN,Midfilder,"58,500",18,35,0,35
3065,Gil Vicente,Primiera Liga,GHA,Forward,"58,000",22,1,0,1
3066,Hoffenheim,Bundesliga,USA,Forward,"57,000",21,25,0,25
3067,Gil Vicente,Primiera Liga,BRA,Defender,"56,000",22,56,0,56
3068,PTM,Primiera Liga,POR,Defender,"56,000",25,157,0,157
3069,Benfica,Primiera Liga,SWE,Goalkeeper,"56,000",18,0,0,0
3070,Salento,Serie A,BEL,Defender,"56,000",20,0,0,0
3071,VIZ,Primiera Liga,CIV,Defender,"56,000",25,84,0,84
3072,PTM,Primiera Liga,BRA,Forward,"56,000",23,50,0,50
3073,Santa Clara,Primiera Liga,BRA,Defender,"56,000",20,23,0,23
3074,Santa Clara,Primiera Liga,POR,Defender,"56,000",23,89,0,89
3075,Salento,Serie A,ITA,Defender,"55,500",26,173,0,173
3076,Casa Pia,Primiera Liga,BRA,Defender,"54,500",24,54,0,54
3077,A. Madrid,La Liga,ESP,Forward,"54,000",20,34,0,34
3078,Montpellier,Ligue 1 Uber Eats,FRA,Defender,"54,000",21,0,0,0
3079,Casa Pia,Primiera Liga,VEN,Defender,"54,000",21,142,0,142
3080,Rio Ave,Primiera Liga,CRO,Defender,"54,000",24,118,0,118
3081,Udinese,Serie A,BEL,Forward,"53,500",18,9,0,9
3082,Udinese,Serie A,POR,Defender,"53,500",20,19,0,19
3083,Barcelona,La Liga,ESP,Midfilder,"53,500",18,21,0,21
3084,Parthenope,Serie A,ESP,Midfilder,"53,000",19,0,0,0
3085,Arouca,Primiera Liga,VEN,Defender,"52,000",31,191,28,219
3086,FC Porto,Primiera Liga,POR,Forward,"52,000",18,0,0,0
3087,FC Porto,Primiera Liga,POR,Midfilder,"52,000",18,0,0,0
3088,PTM,Primiera Liga,BRA,Midfilder,"52,000",22,25,0,25
3089,Benfica,Primiera Liga,MOZ,Forward,"52,000",18,7,0,7
3090,Troyes,Ligue 1 Uber Eats,ENG,Forward,"52,000",24,55,0,55
3091,Benfica,Primiera Liga,POR,Forward,"52,000",18,0,0,0
3092,Santa Clara,Primiera Liga,POR,Defender,"52,000",23,51,0,51
3093,Sporting CP,Primiera Liga,POR,Defender,"52,000",18,0,0,0
3094,Arouca,Primiera Liga,BRA,Defender,"52,000",26,49,0,49
3095,Sporting CP,Primiera Liga,POR,Midfilder,"52,000",19,0,0,0
3096,Sporting CP,Primiera Liga,POR,Forward,"52,000",18,0,0,0
3097,BVT,Primiera Liga,POR,Defender,"52,000",21,22,0,22
3098,FC Porto,Primiera Liga,POR,Midfilder,"52,000",18,0,0,0
3099,Benfica,Primiera Liga,ALG,Midfilder,"52,000",18,0,0,0
3100,Sporting CP,Primiera Liga,POR,Forward,"52,000",19,0,0,0
3101,Benfica,Primiera Liga,POR,Forward,"52,000",18,0,0,0
3102,FC Porto,Primiera Liga,POR,Defender,"52,000",18,0,0,0
3103,Sporting CP,Primiera Liga,GNB,Forward,"52,000",18,0,0,0
3104,Wolves,Premier League,IRL,Forward,"52,000",19,0,0,0
3105,Arsenal,Premier League,NED,Forward,"52,000",19,0,0,0
3106,Leicester,Premier League,ENG,Defender,"52,000",18,1,0,1
3107,Brighton,Premier League,ENG,Midfilder,"52,000",18,0,0,0
3108,West Ham,Premier League,ENG,Midfilder,"52,000",18,0,0,0
3109,Arsenal,Premier League,ENG,Goalkeeper,"52,000",19,0,0,0
3110,Wolves,Premier League,NED,Defender,"52,000",18,0,0,0
3111,Nottm Forest,Premier League,NIR,Midfilder,"52,000",18,0,0,0
3112,Tottenham,Premier League,EST,Defender,"52,000",19,31,16,47
3113,Chelsea,Premier League,ENG,Forward,"52,000",19,18,0,18
3114,Nottm Forest,Premier League,SWE,Forward,"52,000",21,4,0,4
3115,Brentford,Premier League,ENG,Forward,"52,000",20,0,0,0
3116,Man UFC,Premier League,ENG,Midfilder,"52,000",18,0,0,0
3117,Arsenal,Premier League,NIR,Defender,"52,000",18,0,0,0
3118,Arsenal,Premier League,ENG,Defender,"52,000",18,0,0,0
3119,Aston Villa,Premier League,ENG,Forward,"52,000",18,1,0,1
3120,Southampton,Premier League,ENG,Forward,"52,000",18,0,0,0
3121,Southampton,Premier League,FRA,Defender,"52,000",18,0,0,0
3122,Arsenal,Premier League,IRL,Midfilder,"52,000",18,4,0,4
3123,Everton,Premier League,ENG,Defender,"52,000",21,1,0,1
3124,Fulham,Premier League,SUI,Midfilder,"52,000",18,0,0,0
3125,Everton,Premier League,NIR,Midfilder,"52,000",18,1,0,1
3126,Man UFC,Premier League,ENG,Defender,"52,000",18,0,0,0
3127,Man UFC,Premier League,CZE,Goalkeeper,"52,000",18,0,0,0
3128,Leicester,Premier League,ENG,Forward,"52,000",18,1,0,1
3129,Nottm Forest,Premier League,SCO,Goalkeeper,"52,000",21,46,0,46
3130,West Ham,Premier League,HUN,Goalkeeper,"52,000",19,0,0,0
3131,West Ham,Premier League,ENG,Defender,"52,000",19,3,0,3
3132,Aston Villa,Premier League,ENG,Defender,"52,000",19,32,0,32
3133,Everton,Premier League,ENG,Forward,"52,000",18,0,0,0
3134,Leicester,Premier League,USA,Goalkeeper,"52,000",19,0,0,0
3135,Man UFC,Premier League,COL,Forward,"52,000",19,0,0,0
3136,Tottenham,Premier League,SLE,Defender,"52,000",20,0,2,2
3137,Tottenham,Premier League,SCO,Defender,"52,000",19,0,0,0
3138,Wolves,Premier League,NIR,Defender,"52,000",19,16,0,16
3139,Tottenham,Premier League,ENG,Goalkeeper,"52,000",18,0,0,0
3140,Tottenham,Premier League,ESP,Midfilder,"52,000",19,0,0,0
3141,Wolves,Premier League,CHN,Forward,"52,000",21,10,0,10
3142,Tottenham,Premier League,ENG,Midfilder,"52,000",18,0,0,0
3143,Brighton,Premier League,ENG,Defender,"52,000",19,0,0,0
3144,Leicester,Premier League,ENG,Defender,"52,000",19,0,0,0
3145,Newcastle,Premier League,SCO,Forward,"52,000",19,0,0,0
3146,Arouca,Primiera Liga,POR,Defender,"52,000",20,16,0,16
3147,Parthenope,Serie A,FRA,Defender,"51,500",22,16,0,16
3148,Salento,Serie A,FRA,Defender,"51,500",22,50,0,50
3149,Salento,Serie A,GER,Defender,"51,500",18,0,0,0
3150,Schalke 04,Bundesliga,GER,Defender,"51,500",18,0,0,0
3151,Mainz 05,Bundesliga,SRB,Defender,"51,500",18,0,0,0
3152,Schalke 04,Bundesliga,GER,Defender,"51,500",18,0,0,0
3153,VfL Wolfsburg,Bundesliga,GER,Goalkeeper,"51,500",19,0,0,0
3154,PTM,Primiera Liga,CIV,Defender,"51,500",22,41,0,41
3155,PTM,Primiera Liga,BRA,Defender,"51,500",20,0,0,0
3156,Sporting CP,Primiera Liga,POR,Defender,"51,500",19,0,0,0
3157,VIZ,Primiera Liga,USA,Forward,"51,500",18,20,0,20
3158,Santa Clara,Primiera Liga,POR,Goalkeeper,"51,500",27,129,0,129
3159,Casa Pia,Primiera Liga,CPV,Midfilder,"51,500",31,321,1,322
3160,Chaves,Primiera Liga,BRA,Goalkeeper,"50,500",26,98,0,98
3161,BRG,Primiera Liga,POR,Defender,"50,500",18,0,0,0
3162,BRG,Primiera Liga,POR,Forward,"50,500",18,0,0,0
3163,AC Ajaccio,Ligue 1 Uber Eats,FRA,Midfilder,"50,000",20,43,0,43
3164,Chaves,Primiera Liga,CIV,Defender,"49,500",23,50,0,50
3165,VTSC,Primiera Liga,BEL,Forward,"49,500",18,0,0,0
3166,RC Lens,Ligue 1 Uber Eats,POL,Midfilder,"49,000",22,111,0,111
3167,Montpellier,Ligue 1 Uber Eats,FRA,Midfilder,"49,000",22,84,0,84
3168,Arouca,Primiera Liga,BRA,Goalkeeper,"47,500",26,30,0,30
3169,Mainz 05,Bundesliga,LVA,Forward,"47,500",18,0,0,0
3170,Mainz 05,Bundesliga,CRO,Midfilder,"47,500",18,0,0,0
3171,P. Ferreira,Primiera Liga,POR,Defender,"47,000",21,39,0,39
3172,BRG,Primiera Liga,EQG,Forward,"47,000",21,2,10,12
3173,Famalicao,Primiera Liga,BRA,Midfilder,"47,000",18,0,0,0
3174,Atalanta,Serie A,CZE,Midfilder,"47,000",20,2,0,2
3175,Crystal Palace,Premier League,ENG,Forward,"47,000",19,0,0,0
3176,Fulham,Premier League,ENG,Midfilder,"47,000",21,20,0,20
3177,Crystal Palace,Premier League,ENG,Midfilder,"47,000",18,0,0,0
3178,Crystal Palace,Premier League,ENG,Defender,"47,000",19,32,0,32
3179,Crystal Palace,Premier League,WAL,Midfilder,"47,000",18,0,0,0
3180,Tottenham,Premier League,IRL,Goalkeeper,"47,000",19,1,0,1
3181,Everton,Premier League,SVN,Goalkeeper,"47,000",19,0,0,0
3182,Crystal Palace,Premier League,ENG,Goalkeeper,"47,000",18,0,0,0
3183,Crystal Palace,Premier League,ENG,Midfilder,"47,000",18,0,0,0
3184,Fiorentina,Serie A,BUL,Midfilder,"46,000",19,7,0,7
3185,Capitoline,Serie A,ITA,Defender,"46,000",18,0,0,0
3186,Milan,Serie A,ITA,Forward,"45,500",19,1,0,1
3187,PSG,Ligue 1 Uber Eats,FRA,Goalkeeper,"45,500",19,0,0,0
3188,Arouca,Primiera Liga,BRA,Forward,"45,000",23,32,0,32
3189,Aston Villa,Premier League,IRL,Defender,"44,000",18,0,0,0
3190,Aston Villa,Premier League,ENG,Forward,"44,000",20,5,0,5
3191,Aston Villa,Premier League,ENG,Defender,"44,000",20,0,0,0
3192,Milan,Serie A,ITA,Midfilder,"43,500",18,0,0,0
3193,P. Ferreira,Primiera Liga,SVN,Goalkeeper,"43,500",24,107,0,107
3194,Santa Clara,Primiera Liga,BRA,Midfilder,"43,500",21,26,0,26
3195,Montpellier,Ligue 1 Uber Eats,POR,Goalkeeper,"43,500",23,6,0,6
3196,Gil Vicente,Primiera Liga,BRA,Defender,"43,500",21,3,0,3
3197,BRG,Primiera Liga,POR,Midfilder,"43,500",19,0,0,0
3198,Famalicao,Primiera Liga,POR,Defender,"43,500",22,7,0,7
3199,Arouca,Primiera Liga,BRA,Forward,"43,500",20,23,0,23
3200,Estoril Praia,Primiera Liga,POR,Midfilder,"43,500",20,8,0,8
3201,BRG,Primiera Liga,SEN,Midfilder,"43,500",19,0,0,0
3202,PTM,Primiera Liga,POR,Midfilder,"43,500",23,5,0,5
3203,BRG,Primiera Liga,BRA,Goalkeeper,"43,500",20,1,0,1
3204,PTM,Primiera Liga,POR,Forward,"43,500",22,33,0,33
3205,Schalke 04,Bundesliga,GER,Defender,"43,000",18,0,0,0
3206,Mainz 05,Bundesliga,GER,Goalkeeper,"43,000",18,0,0,0
3207,Hertha Berlin,Bundesliga,SUI,Forward,"43,000",21,27,0,27
3208,Mainz 05,Bundesliga,BIH,Defender,"43,000",18,0,0,0
3209,FC Bayern,Bundesliga,GER,Goalkeeper,"43,000",28,67,0,67
3210,Mainz 05,Bundesliga,GER,Midfilder,"43,000",18,0,0,0
3211,Rio Ave,Primiera Liga,POR,Forward,"42,500",21,33,0,33
3212,BVT,Primiera Liga,POR,Forward,"42,500",18,0,0,0
3213,Estoril Praia,Primiera Liga,FRA,Midfilder,"42,500",21,33,0,33
3214,Famalicao,Primiera Liga,POR,Midfilder,"42,500",19,14,0,14
3215,Milan,Serie A,ITA,Forward,"42,500",20,0,0,0
3216,Sampdoria,Serie A,VEN,Midfilder,"41,500",19,60,1,61
3217,Leicester,Premier League,BER,Defender,"41,500",18,0,1,1
3218,Bournemouth,Premier League,ENG,Defender,"41,500",20,15,0,15
3219,Newcastle,Premier League,ENG,Defender,"41,500",20,6,0,6
3220,Leicester,Premier League,USA,Midfilder,"41,500",18,0,0,0
3221,Leicester,Premier League,ENG,Midfilder,"41,500",18,0,0,0
3222,Man UFC,Premier League,ENG,Defender,"41,500",18,0,0,0
3223,Newcastle,Premier League,IRL,Defender,"41,500",18,31,0,31
3224,Sassuolo,Serie A,ITA,Goalkeeper,"41,500",19,0,0,0
3225,Bologna,Serie A,FIN,Forward,"41,500",19,0,0,0
3226,BRG,Primiera Liga,POR,Defender,"41,500",20,11,0,11
3227,Bologna,Serie A,ITA,Goalkeeper,"41,000",18,1,0,1
3228,Capitoline,Serie A,ITA,Forward,"41,000",19,0,0,0
3229,Parthenope,Serie A,POL,Goalkeeper,"41,000",20,0,0,0
3230,Milan,Serie A,ITA,Forward,"41,000",18,0,0,0
3231,Capitoline,Serie A,BIH,Midfilder,"40,500",19,26,0,26
3232,Bologna,Serie A,ITA,Goalkeeper,"40,500",22,56,0,56
3233,Liverpool,Premier League,NIR,Goalkeeper,"40,000",21,9,0,9
3234,Liverpool,Premier League,ENG,Defender,"40,000",18,0,0,0
3235,Liverpool,Premier League,POL,Forward,"40,000",18,0,0,0
3236,Liverpool,Premier League,ENG,Forward,"40,000",20,0,0,0
3237,Liverpool,Premier League,ENG,Goalkeeper,"40,000",19,0,0,0
3238,Liverpool,Premier League,GER,Defender,"40,000",18,0,0,0
3239,Capitoline,Serie A,FRA,Defender,"40,000",19,0,0,0
3240,Casa Pia,Primiera Liga,BRA,Goalkeeper,"39,000",24,27,0,27
3241,VTSC,Primiera Liga,CAN,Forward,"39,000",18,0,0,0
3242,BVT,Primiera Liga,POR,Forward,"39,000",22,33,0,33
3243,Aston Villa,Premier League,ENG,Forward,"39,000",18,0,0,0
3244,Wolves,Premier League,WAL,Midfilder,"39,000",19,0,0,0
3245,Man UFC,Premier League,NIR,Goalkeeper,"39,000",19,13,0,13
3246,Newcastle,Premier League,ENG,Goalkeeper,"39,000",20,0,0,0
3247,FC Nantes,Ligue 1 Uber Eats,FRA,Midfilder,"39,000",19,3,0,3
3248,West Ham,Premier League,ENG,Forward,"39,000",19,0,0,0
3249,Leicester,Premier League,IRL,Goalkeeper,"39,000",18,3,0,3
3250,West Ham,Premier League,ENG,Defender,"39,000",18,2,0,2
3251,Wolves,Premier League,ENG,Defender,"39,000",21,0,0,0
3252,Aston Villa,Premier League,NIR,Midfilder,"39,000",18,0,0,0
3253,Leeds,Premier League,ENG,Defender,"39,000",18,1,0,1
3254,Bologna,Serie A,ITA,Defender,"38,500",18,1,0,1
3255,Schalke 04,Bundesliga,GER,Goalkeeper,"38,500",18,0,0,0
3256,Torino,Serie A,FRA,Midfilder,"38,500",19,0,0,0
3257,RC Lens,Ligue 1 Uber Eats,FRA,Forward,"38,500",21,23,0,23
3258,VIZ,Primiera Liga,ESP,Midfilder,"38,500",22,64,0,64
3259,Atalanta,Serie A,ITA,Forward,"38,000",19,1,0,1
3260,Santa Clara,Primiera Liga,POR,Forward,"38,000",24,84,0,84
3261,PTM,Primiera Liga,KOR,Defender,"38,000",28,238,13,251
3262,Famalicao,Primiera Liga,MNE,Defender,"38,000",20,0,0,0
3263,BRG,Primiera Liga,POR,Defender,"38,000",19,0,0,0
3264,Famalicao,Primiera Liga,BRA,Defender,"38,000",22,6,0,6
3265,PTM,Primiera Liga,BRA,Midfilder,"38,000",21,2,0,2
3266,VfL Bochum,Bundesliga,GER,Defender,"37,500",18,0,0,0
3267,Fiorentina,Serie A,ITA,Forward,"37,500",19,1,0,1
3268,Real Hispalis,La Liga,ESP,Defender,"37,500",18,3,0,3
3269,P. Ferreira,Primiera Liga,POR,Midfilder,"37,500",20,1,0,1
3270,Angers SCO,Ligue 1 Uber Eats,GAB,Forward,"37,500",21,23,4,27
3271,Casa Pia,Primiera Liga,BRA,Goalkeeper,"37,000",24,15,0,15
3272,BRG,Primiera Liga,POR,Defender,"37,000",19,0,0,0
3273,BRG,Primiera Liga,POR,Midfilder,"37,000",18,0,0,0
3274,BRG,Primiera Liga,GNB,Forward,"37,000",18,0,0,0
3275,Brest,Ligue 1 Uber Eats,FRA,Goalkeeper,"37,000",23,7,0,7
3276,Newcastle,Premier League,ENG,Forward,"36,500",18,5,0,5
3277,Nottm Forest,Premier League,ENG,Goalkeeper,"36,500",21,7,0,7
3278,Cremonese,Serie A,ITA,Midfilder,"36,000",20,31,0,31
3279,Salento,Serie A,FIN,Goalkeeper,"36,000",19,4,0,4
3280,Inter,Serie A,ITA,Midfilder,"36,000",21,9,0,9
3281,Famalicao,Primiera Liga,POR,Midfilder,"36,000",19,0,0,0
3282,Brianza,Serie A,BRA,Forward,"36,000",19,0,0,0
3283,Capitoline,Serie A,ITA,Midfilder,"35,500",18,0,0,0
3284,Atalanta,Serie A,SEN,Goalkeeper,"35,500",22,21,0,21
3285,Bologna,Serie A,NED,Midfilder,"35,000",19,8,0,8
3286,Bologna,Serie A,FIN,Defender,"35,000",19,42,0,42
3287,Fulham,Premier League,ENG,Forward,"34,500",20,23,0,23
3288,Brianza,Serie A,ITA,Forward,"34,500",18,19,0,19
3289,SC Freiburg,Bundesliga,GER,Midfilder,"34,500",20,51,0,51
3290,MRT,Primiera Liga,BRA,Goalkeeper,"34,500",32,123,0,123
3291,Brianza,Serie A,ITA,Midfilder,"34,500",21,63,0,63
3292,Leeds,Premier League,ENG,Goalkeeper,"34,000",18,0,0,0
3293,Brentford,Premier League,IRL,Defender,"34,000",18,16,0,16
3294,Newcastle,Premier League,ENG,Forward,"34,000",18,0,0,0
3295,Bologna,Serie A,ITA,Forward,"33,500",20,2,0,2
3296,Atalanta,Serie A,ZAM,Midfilder,"33,500",18,22,0,22
3297,Lazio,Serie A,CIV,Midfilder,"33,500",19,0,0,0
3298,BRG,Primiera Liga,POR,Midfilder,"33,500",18,0,0,0
3299,BRG,Primiera Liga,SRB,Defender,"33,500",20,2,0,2
3300,VIZ,Primiera Liga,NGA,Forward,"33,500",20,4,0,4
3301,Famalicao,Primiera Liga,POR,Defender,"33,500",18,0,0,0
3302,Estoril Praia,Primiera Liga,BRA,Forward,"33,500",20,0,0,0
3303,Estoril Praia,Primiera Liga,BRA,Forward,"33,500",20,0,0,0
3304,Gil Vicente,Primiera Liga,POR,Goalkeeper,"33,500",22,2,0,2
3305,BRG,Primiera Liga,POR,Midfilder,"33,500",21,14,0,14
3306,VIZ,Primiera Liga,USA,Midfilder,"33,500",19,17,0,17
3307,PTM,Primiera Liga,BRA,Defender,"33,500",20,3,0,3
3308,Famalicao,Primiera Liga,POR,Defender,"33,500",21,29,0,29
3309,Famalicao,Primiera Liga,POR,Goalkeeper,"33,500",20,1,0,1
3310,Estoril Praia,Primiera Liga,POR,Goalkeeper,"33,500",19,0,0,0
3311,Milan,Serie A,ITA,Midfilder,"32,500",20,0,0,0
3312,Fiorentina,Serie A,ALB,Forward,"32,500",19,4,0,4
3313,Bologna,Serie A,ITA,Defender,"32,500",18,0,0,0
3314,Rio Ave,Primiera Liga,BRA,Goalkeeper,"32,500",22,14,0,14
3315,RB Leipzig,Bundesliga,GER,Goalkeeper,"32,500",18,0,0,0
3316,Arouca,Primiera Liga,POR,Goalkeeper,"32,000",22,52,0,52
3317,Torino,Serie A,ITA,Goalkeeper,"32,000",19,33,0,33
3318,Lazio,Serie A,ITA,Defender,"32,000",19,0,0,0
3319,Lazio,Serie A,SUI,Defender,"32,000",20,0,0,0
3320,RB Leipzig,Bundesliga,GER,Goalkeeper,"32,000",18,0,0,0
3321,Fiorentina,Serie A,ITA,Forward,"31,500",19,3,0,3
3322,Salento,Serie A,ROU,Midfilder,"31,500",18,3,0,3
3323,Lazio,Serie A,PAR,Forward,"31,500",19,29,0,29
3324,BRG,Primiera Liga,GNB,Defender,"31,500",19,0,0,0
3325,Famalicao,Primiera Liga,POR,Defender,"31,500",19,0,0,0
3326,P. Ferreira,Primiera Liga,POR,Defender,"31,500",20,30,0,30
3327,Sassuolo,Serie A,IRL,Defender,"31,500",18,20,0,20
3328,Bologna,Serie A,FRA,Defender,"31,500",18,0,0,0
3329,Leicester,Premier League,ENG,Defender,"31,000",18,0,0,0
3330,Nottm Forest,Premier League,ENG,Goalkeeper,"31,000",18,0,0,0
3331,Aston Villa,Premier League,ENG,Defender,"31,000",18,0,0,0
3332,Tottenham,Premier League,ENG,Defender,"31,000",18,4,0,4
3333,Brighton,Premier League,IRL,Defender,"31,000",18,1,0,1
3334,Fulham,Premier League,FIN,Forward,"31,000",20,36,0,36
3335,Aston Villa,Premier League,ENG,Midfilder,"31,000",18,0,0,0
3336,Crystal Palace,Premier League,ENG,Defender,"31,000",19,0,0,0
3337,Crystal Palace,Premier League,IRQ,Defender,"31,000",19,0,0,0
3338,Man City,Premier League,ENG,Midfilder,"31,000",19,0,0,0
3339,Fulham,Premier League,USA,Goalkeeper,"31,000",18,0,0,0
3340,Everton,Premier League,WAL,Defender,"31,000",19,0,0,0
3341,Crystal Palace,Premier League,ENG,Forward,"31,000",18,5,0,5
3342,Crystal Palace,Premier League,ENG,Midfilder,"31,000",18,0,0,0
3343,Crystal Palace,Premier League,ENG,Goalkeeper,"31,000",18,0,0,0
3344,Fulham,Premier League,WAL,Defender,"31,000",19,0,0,0
3345,Everton,Premier League,ENG,Defender,"31,000",18,0,0,0
3346,Newcastle,Premier League,ENG,Goalkeeper,"31,000",18,0,0,0
3347,Nottm Forest,Premier League,ENG,Midfilder,"31,000",18,0,0,0
3348,Fulham,Premier League,ENG,Defender,"31,000",19,0,0,0
3349,Everton,Premier League,ENG,Defender,"31,000",18,0,0,0
3350,Crystal Palace,Premier League,ENG,Defender,"31,000",18,0,0,0
3351,Brighton,Premier League,FRA,Midfilder,"31,000",19,2,0,2
3352,Wolves,Premier League,AUS,Midfilder,"31,000",18,0,0,0
3353,Nottm Forest,Premier League,IRL,Defender,"31,000",19,0,0,0
3354,Crystal Palace,Premier League,ENG,Defender,"31,000",18,0,0,0
3355,Crystal Palace,Premier League,ENG,Forward,"31,000",18,0,0,0
3356,Aston Villa,Premier League,ENG,Defender,"31,000",18,0,0,0
3357,Eintracht Frankfurt,Bundesliga,CRO,Defender,"31,000",22,75,0,75
3358,MRT,Primiera Liga,POR,Midfilder,"31,000",20,7,0,7
3359,BRG,Primiera Liga,POR,Defender,"31,000",18,0,0,0
3360,VTSC,Primiera Liga,POR,Forward,"31,000",18,0,0,0
3361,BRG,Primiera Liga,POR,Forward,"31,000",19,0,0,0
3362,PTM,Primiera Liga,BRA,Goalkeeper,"31,000",21,0,0,0
3363,Famalicao,Primiera Liga,POR,Defender,"31,000",19,0,0,0
3364,BRG,Primiera Liga,POR,Defender,"31,000",18,2,0,2
3365,BVT,Primiera Liga,POR,Goalkeeper,"31,000",21,2,0,2
3366,BRG,Primiera Liga,POR,Goalkeeper,"31,000",20,0,0,0
3367,VIZ,Primiera Liga,POR,Goalkeeper,"31,000",18,0,0,0
3368,Estoril Praia,Primiera Liga,POR,Midfilder,"31,000",18,7,0,7
3369,BRG,Primiera Liga,POR,Defender,"31,000",19,0,0,0
3370,BRG,Primiera Liga,POR,Forward,"31,000",18,0,0,0
3371,BRG,Primiera Liga,POR,Defender,"31,000",21,1,0,1
3372,VIZ,Primiera Liga,COL,Midfilder,"31,000",19,0,0,0
3373,BRG,Primiera Liga,POR,Goalkeeper,"31,000",19,0,0,0
3374,BRG,Primiera Liga,POR,Defender,"31,000",20,0,0,0
3375,BRG,Primiera Liga,CAN,Defender,"31,000",20,0,0,0
3376,BRG,Primiera Liga,ANG,Forward,"31,000",18,17,0,17
3377,Juventus,Serie A,ITA,Forward,"31,000",19,6,0,6
3378,PTM,Primiera Liga,JPN,Forward,"31,000",19,0,0,0
3379,BRG,Primiera Liga,POR,Midfilder,"31,000",18,0,0,0
3380,MRT,Primiera Liga,NGA,Midfilder,"31,000",21,5,0,5
3381,VIZ,Primiera Liga,POR,Defender,"31,000",19,1,0,1
3382,Capitoline,Serie A,FRA,Defender,"30,500",19,0,0,0
3383,VIZ,Primiera Liga,EGY,Goalkeeper,"30,500",19,0,0,0
3384,Arouca,Primiera Liga,USA,Forward,"30,000",24,157,0,157
3385,Juventus,Serie A,ITA,Defender,"30,000",19,0,0,0
3386,Borussia Dortmund,Bundesliga,GER,Goalkeeper,"30,000",18,0,0,0
3387,VfB Stuttgart,Bundesliga,GER,Defender,"30,000",18,0,0,0
3388,PTM,Primiera Liga,KOR,Forward,"30,000",19,0,0,0
3389,FC Augsburg,Bundesliga,POL,Goalkeeper,"30,000",18,0,0,0
3390,Juventus,Serie A,ITA,Defender,"29,000",19,0,0,0
3391,Milan,Serie A,FRA,Defender,"29,000",18,0,0,0
3392,Parthenope,Serie A,ITA,Defender,"29,000",19,0,0,0
3393,Estoril Praia,Primiera Liga,BEL,Midfilder,"29,000",20,5,0,5
3394,Estoril Praia,Primiera Liga,BRA,Midfilder,"29,000",20,45,0,45
3395,Gil Vicente,Primiera Liga,CRC,Midfilder,"29,000",20,93,4,97
3396,Bayer 04,Bundesliga,GER,Midfilder,"29,000",18,0,0,0
3397,Hertha Berlin,Bundesliga,GER,Goalkeeper,"29,000",18,0,0,0
3398,VfB Stuttgart,Bundesliga,AUT,Midfilder,"29,000",18,0,0,0
3399,Bayer 04,Bundesliga,ESP,Midfilder,"29,000",18,0,0,0
3400,Hoffenheim,Bundesliga,GER,Forward,"29,000",18,0,0,0
3401,Union Berlin,Bundesliga,GER,Midfilder,"29,000",18,0,0,0
3402,VfL Bochum,Bundesliga,TUR,Midfilder,"29,000",18,0,0,0
3403,Union Berlin,Bundesliga,GER,Defender,"29,000",18,0,0,0
3404,Bayer 04,Bundesliga,GER,Midfilder,"29,000",18,0,0,0
3405,Hoffenheim,Bundesliga,SUI,Defender,"29,000",18,0,0,0
3406,VfL Bochum,Bundesliga,GER,Defender,"29,000",18,0,0,0
3407,Hoffenheim,Bundesliga,GER,Defender,"29,000",18,0,0,0
3408,Hoffenheim,Bundesliga,GER,Goalkeeper,"29,000",18,0,0,0
3409,SC Freiburg,Bundesliga,CAN,Midfilder,"29,000",18,0,0,0
3410,SC Freiburg,Bundesliga,ARG,Defender,"29,000",18,0,0,0
3411,SC Freiburg,Bundesliga,FRA,Defender,"29,000",18,0,0,0
3412,FC Augsburg,Bundesliga,MNE,Forward,"29,000",18,0,0,0
3413,VfL Bochum,Bundesliga,KOS,Forward,"29,000",18,0,0,0
3414,FC Augsburg,Bundesliga,GER,Forward,"29,000",18,0,0,0
3415,1. FC Koln,Bundesliga,GER,Defender,"29,000",18,0,0,0
3416,VfL Bochum,Bundesliga,ANG,Forward,"29,000",18,0,0,0
3417,FC Augsburg,Bundesliga,GER,Defender,"29,000",18,0,0,0
3418,FC Augsburg,Bundesliga,GER,Defender,"29,000",18,0,0,0
3419,1. FC Koln,Bundesliga,GER,Defender,"29,000",18,0,0,0
3420,Hoffenheim,Bundesliga,ISL,Goalkeeper,"29,000",18,0,0,0
3421,1. FC Koln,Bundesliga,GER,Goalkeeper,"29,000",18,0,0,0
3422,VfL Bochum,Bundesliga,GER,Goalkeeper,"29,000",18,0,0,0
3423,1. FC Koln,Bundesliga,GER,Midfilder,"29,000",18,0,0,0
3424,Borussia Dortmund,Bundesliga,GER,Defender,"29,000",18,0,0,0
3425,Union Berlin,Bundesliga,GER,Goalkeeper,"29,000",18,0,0,0
3426,Hertha Berlin,Bundesliga,GER,Forward,"29,000",18,0,0,0
3427,VfL Bochum,Bundesliga,GER,Midfilder,"29,000",18,0,0,0
3428,1. FC Koln,Bundesliga,GER,Forward,"29,000",18,0,0,0
3429,SV Werder,Bundesliga,GER,Goalkeeper,"29,000",18,0,0,0
3430,FC Augsburg,Bundesliga,GER,Midfilder,"29,000",18,3,0,3
3431,VfL Bochum,Bundesliga,USA,Defender,"29,000",18,0,0,0
3432,VfL Bochum,Bundesliga,GER,Forward,"29,000",18,0,0,0
3433,Hoffenheim,Bundesliga,GER,Defender,"29,000",18,0,0,0
3434,VfL Bochum,Bundesliga,GER,Defender,"29,000",18,0,0,0
3435,Bayer 04,Bundesliga,GER,Defender,"29,000",18,0,0,0
3436,Hoffenheim,Bundesliga,FRA,Forward,"29,000",18,0,0,0
3437,Hertha Berlin,Bundesliga,GER,Goalkeeper,"29,000",18,0,0,0
3438,Bayer 04,Bundesliga,KOR,Forward,"29,000",18,0,0,0
3439,FC Augsburg,Bundesliga,BIH,Goalkeeper,"29,000",18,0,0,0
3440,Hertha Berlin,Bundesliga,KOS,Midfilder,"29,000",18,0,0,0
3441,Hertha Berlin,Bundesliga,GER,Defender,"29,000",18,0,0,0
3442,Hertha Berlin,Bundesliga,GER,Midfilder,"29,000",18,0,0,0
3443,Bayer 04,Bundesliga,GER,Forward,"29,000",18,0,0,0
3444,Bayer 04,Bundesliga,GER,Goalkeeper,"29,000",18,0,0,0
3445,Union Berlin,Bundesliga,GER,Midfilder,"29,000",18,0,0,0
3446,Union Berlin,Bundesliga,GER,Midfilder,"29,000",18,0,0,0
3447,VfB Stuttgart,Bundesliga,GER,Forward,"29,000",18,0,0,0
3448,FC Augsburg,Bundesliga,LTU,Midfilder,"29,000",18,18,0,18
3449,Schalke 04,Bundesliga,POL,Defender,"29,000",18,18,0,18
3450,RB Leipzig,Bundesliga,GHA,Forward,"29,000",18,1,0,1
3451,RB Leipzig,Bundesliga,GER,Defender,"29,000",18,0,0,0
3452,VfB Stuttgart,Bundesliga,POR,Defender,"29,000",18,0,0,0
3453,RB Leipzig,Bundesliga,GER,Defender,"29,000",18,0,0,0
3454,Bayer 04,Bundesliga,GER,Defender,"29,000",18,0,0,0
3455,SC Freiburg,Bundesliga,GER,Midfilder,"29,000",18,0,0,0
3456,RB Leipzig,Bundesliga,GER,Defender,"29,000",18,0,0,0
3457,RB Leipzig,Bundesliga,GER,Defender,"29,000",18,0,0,0
3458,RB Leipzig,Bundesliga,SUI,Forward,"29,000",18,1,0,1
3459,VfB Stuttgart,Bundesliga,SWE,Midfilder,"29,000",18,0,0,0
3460,RB Leipzig,Bundesliga,GER,Forward,"29,000",18,0,0,0
3461,VfB Stuttgart,Bundesliga,GER,Defender,"29,000",18,0,0,0
3462,VfB Stuttgart,Bundesliga,GER,Defender,"29,000",18,0,0,0
3463,1. FC Koln,Bundesliga,GER,Goalkeeper,"29,000",25,1,0,1
3464,SC Freiburg,Bundesliga,GER,Forward,"29,000",18,0,0,0
3465,OGC Nice,Ligue 1 Uber Eats,FRA,Forward,"29,000",18,0,0,0
3466,OGC Nice,Ligue 1 Uber Eats,FRA,Midfilder,"29,000",18,0,0,0
3467,Toulouse FC,Ligue 1 Uber Eats,CMR,Defender,"29,000",18,0,0,0
3468,Brest,Ligue 1 Uber Eats,FRA,Forward,"29,000",18,0,0,0
3469,OM,Ligue 1 Uber Eats,FRA,Midfilder,"29,000",18,0,0,0
3470,AJ Auxerre,Ligue 1 Uber Eats,FRA,Forward,"29,000",18,0,0,0
3471,Brest,Ligue 1 Uber Eats,FRA,Defender,"29,000",18,0,0,0
3472,Angers SCO,Ligue 1 Uber Eats,FRA,Midfilder,"29,000",18,0,0,0
3473,Brest,Ligue 1 Uber Eats,BEL,Midfilder,"29,000",18,0,0,0
3474,AC Ajaccio,Ligue 1 Uber Eats,FRA,Goalkeeper,"29,000",28,13,0,13
3475,Brest,Ligue 1 Uber Eats,FRA,Goalkeeper,"29,000",18,0,0,0
3476,Angers SCO,Ligue 1 Uber Eats,FRA,Defender,"29,000",18,0,0,0
3477,Brest,Ligue 1 Uber Eats,FRA,Defender,"29,000",18,0,0,0
3478,Troyes,Ligue 1 Uber Eats,FRA,Forward,"29,000",18,6,0,6
3479,FC Nantes,Ligue 1 Uber Eats,FRA,Goalkeeper,"29,000",18,1,0,1
3480,Brest,Ligue 1 Uber Eats,FRA,Defender,"29,000",18,0,0,0
3481,Reims,Ligue 1 Uber Eats,SEN,Defender,"29,000",18,14,0,14
3482,AC Ajaccio,Ligue 1 Uber Eats,ALG,Midfilder,"29,000",18,0,0,0
3483,VIZ,Primiera Liga,COL,Forward,"29,000",18,0,0,0
3484,Wolves,Premier League,SIN,Defender,"28,500",18,0,0,0
3485,Newcastle,Premier League,ENG,Midfilder,"28,500",18,0,0,0
3486,Newcastle,Premier League,ENG,Midfilder,"28,500",18,0,0,0
3487,VIZ,Primiera Liga,VEN,Forward,"28,500",19,48,0,48
3488,Barcelona,La Liga,ESP,Defender,"28,000",18,0,0,0
3489,Arouca,Primiera Liga,NGA,Forward,"28,000",24,91,0,91
3490,Arouca,Primiera Liga,BRA,Defender,"28,000",22,33,0,33
3491,Milan,Serie A,GRE,Goalkeeper,"27,500",19,0,0,0
3492,Juventus,Serie A,ITA,Defender,"27,500",19,0,0,0
3493,Milan,Serie A,ITA,Defender,"27,500",18,0,0,0
3494,Verona,Serie A,ITA,Forward,"27,500",19,3,0,3
3495,Salento,Serie A,ESP,Defender,"27,500",18,0,0,0
3496,Fulham,Premier League,ENG,Forward,"27,500",18,1,0,1
3497,Hertha Berlin,Bundesliga,GER,Defender,"27,000",18,1,0,1
3498,Udinese,Serie A,ITA,Forward,"27,000",19,0,0,0
3499,Fiorentina,Serie A,ITA,Defender,"27,000",19,0,0,0
3500,Bologna,Serie A,ITA,Forward,"27,000",18,0,0,0
3501,BVT,Primiera Liga,POR,Midfilder,"27,000",19,0,0,0
3502,BVT,Primiera Liga,IRL,Forward,"27,000",18,0,0,0
3503,Sampdoria,Serie A,ITA,Defender,"26,500",20,0,0,0
3504,Empoli,Serie A,FRA,Defender,"26,500",20,0,0,0
3505,Salento,Serie A,ITA,Defender,"26,500",20,13,0,13
3506,Aston Villa,Premier League,ENG,Goalkeeper,"26,000",18,0,0,0
3507,Newcastle,Premier League,ENG,Midfilder,"26,000",18,0,0,0
3508,Newcastle,Premier League,ENG,Midfilder,"26,000",19,0,0,0
3509,Nottm Forest,Premier League,ENG,Forward,"26,000",19,2,0,2
3510,Newcastle,Premier League,ENG,Defender,"26,000",18,0,0,0
3511,Newcastle,Premier League,ENG,Defender,"26,000",19,0,0,0
3512,Newcastle,Premier League,ENG,Defender,"26,000",19,0,0,0
3513,Nottm Forest,Premier League,ENG,Midfilder,"26,000",18,0,0,0
3514,West Ham,Premier League,ENG,Midfilder,"26,000",18,0,0,0
3515,Fulham,Premier League,ENG,Midfilder,"26,000",18,0,0,0
3516,Southampton,Premier League,NIR,Defender,"26,000",18,0,0,0
3517,West Ham,Premier League,NIR,Defender,"26,000",18,0,0,0
3518,Wolves,Premier League,ENG,Defender,"26,000",19,0,0,0
3519,Southampton,Premier League,ENG,Defender,"26,000",20,0,0,0
3520,Leeds,Premier League,NIR,Midfilder,"26,000",18,4,0,4
3521,Southampton,Premier League,ENG,Goalkeeper,"26,000",19,36,0,36
3522,Wolves,Premier League,ISL,Goalkeeper,"26,000",18,1,0,1
3523,Fulham,Premier League,ENG,Defender,"26,000",18,0,0,0
3524,Southampton,Premier League,ENG,Defender,"26,000",19,0,0,0
3525,Southampton,Premier League,ENG,Goalkeeper,"26,000",19,0,0,0
3526,West Ham,Premier League,ENG,Forward,"26,000",20,0,0,0
3527,Bournemouth,Premier League,ENG,Midfilder,"26,000",19,6,0,6
3528,Fulham,Premier League,CYP,Midfilder,"26,000",18,0,0,0
3529,Leicester,Premier League,ENG,Goalkeeper,"26,000",18,0,0,0
3530,Southampton,Premier League,ENG,Forward,"26,000",19,0,0,0
3531,Newcastle,Premier League,ENG,Defender,"26,000",18,0,0,0
3532,West Ham,Premier League,ENG,Defender,"26,000",18,0,0,0
3533,West Ham,Premier League,BER,Forward,"26,000",18,0,2,2
3534,Torino,Serie A,ITA,Forward,"26,000",18,0,0,0
3535,Southampton,Premier League,ENG,Forward,"26,000",18,0,0,0
3536,Wolves,Premier League,ENG,Defender,"26,000",18,0,0,0
3537,Wolves,Premier League,ENG,Defender,"26,000",18,0,0,0
3538,Wolves,Premier League,ENG,Defender,"26,000",18,0,0,0
3539,Wolves,Premier League,JAM,Forward,"26,000",18,5,0,5
3540,Southampton,Premier League,SRB,Midfilder,"26,000",18,0,0,0
3541,Nottm Forest,Premier League,ENG,Midfilder,"26,000",18,2,0,2
3542,Nottm Forest,Premier League,ENG,Forward,"26,000",18,0,0,0
3543,Nottm Forest,Premier League,ENG,Defender,"26,000",18,0,0,0
3544,Southampton,Premier League,ENG,Goalkeeper,"26,000",18,0,0,0
3545,Southampton,Premier League,ENG,Midfilder,"26,000",18,0,0,0
3546,Brighton,Premier League,ENG,Midfilder,"26,000",18,0,0,0
3547,Brighton,Premier League,SVK,Defender,"26,000",18,0,0,0
3548,Brentford,Premier League,ENG,Midfilder,"26,000",20,26,0,26
3549,Inter,Serie A,POL,Forward,"26,000",18,0,0,0
3550,Juventus,Serie A,ITA,Midfilder,"25,500",19,0,0,0
3551,Sassuolo,Serie A,SRB,Defender,"25,000",18,0,0,0
3552,Torino,Serie A,FRA,Defender,"25,000",19,0,0,0
3553,Arouca,Primiera Liga,GHA,Midfilder,"25,000",23,32,0,32
3554,Salento,Serie A,SUI,Midfilder,"25,000",18,16,0,16
3555,Famalicao,Primiera Liga,POR,Midfilder,"25,000",19,0,0,0
3556,Salento,Serie A,SWE,Defender,"25,000",19,0,0,0
3557,BRG,Primiera Liga,POR,Defender,"25,000",19,3,0,3
3558,BRG,Primiera Liga,POR,Midfilder,"25,000",18,0,0,0
3559,Gil Vicente,Primiera Liga,POR,Forward,"25,000",20,22,0,22
3560,BRG,Primiera Liga,POR,Defender,"25,000",20,0,0,0
3561,Casa Pia,Primiera Liga,POR,Defender,"24,500",20,14,0,14
3562,Gil Vicente,Primiera Liga,PER,Midfilder,"24,500",20,17,0,17
3563,Estoril Praia,Primiera Liga,POR,Defender,"24,500",20,5,0,5
3564,Estoril Praia,Primiera Liga,BRA,Forward,"24,500",18,7,0,7
3565,Estoril Praia,Primiera Liga,BRA,Defender,"24,500",20,8,0,8
3566,Parthenope,Serie A,ITA,Midfilder,"24,500",19,0,0,0
3567,Parthenope,Serie A,ITA,Midfilder,"24,500",19,0,0,0
3568,Capitoline,Serie A,ESP,Defender,"24,500",18,0,0,0
3569,Inter,Serie A,ITA,Defender,"24,000",19,12,0,12
3570,PTM,Primiera Liga,POR,Forward,"23,500",23,2,0,2
3571,Torino,Serie A,SWE,Defender,"23,500",18,10,0,10
3572,Torino,Serie A,FRA,Defender,"23,500",18,0,0,0
3573,Salento,Serie A,FIN,Midfilder,"23,500",19,12,0,12
3574,Bournemouth,Premier League,IRL,Defender,"23,500",20,20,0,20
3575,Bournemouth,Premier League,ENG,Goalkeeper,"23,500",19,32,0,32
3576,Bournemouth,Premier League,ENG,Defender,"23,500",19,29,0,29
3577,Sampdoria,Serie A,ITA,Midfilder,"23,000",19,1,0,1
3578,Empoli,Serie A,ALB,Midfilder,"23,000",19,0,0,0
3579,Capitoline,Serie A,FRA,Defender,"23,000",19,0,0,0
3580,Parthenope,Serie A,ITA,Defender,"23,000",19,0,0,0
3581,Sassuolo,Serie A,ITA,Defender,"23,000",19,11,0,11
3582,Sassuolo,Serie A,ITA,Midfilder,"22,500",19,0,0,0
3583,BRG,Primiera Liga,GNB,Forward,"22,500",18,0,0,0
3584,BRG,Primiera Liga,POR,Midfilder,"22,500",20,0,0,0
3585,BRG,Primiera Liga,POR,Midfilder,"22,500",20,0,0,0
3586,Atalanta,Serie A,NOR,Midfilder,"22,500",18,15,0,15
3587,BRG,Primiera Liga,POR,Goalkeeper,"22,500",18,0,0,0
3588,Estoril Praia,Primiera Liga,POR,Forward,"22,500",20,0,0,0
3589,Famalicao,Primiera Liga,POR,Defender,"22,500",18,0,0,0
3590,Famalicao,Primiera Liga,POR,Forward,"22,500",20,0,0,0
3591,VIZ,Primiera Liga,POR,Forward,"22,500",18,3,0,3
3592,Estoril Praia,Primiera Liga,POR,Defender,"22,500",20,10,0,10
3593,Famalicao,Primiera Liga,POR,Midfilder,"22,500",19,1,0,1
3594,BRG,Primiera Liga,POR,Midfilder,"22,500",19,0,0,0
3595,Famalicao,Primiera Liga,POR,Forward,"22,500",19,3,0,3
3596,Gil Vicente,Primiera Liga,POR,Defender,"22,500",22,58,0,58
3597,MRT,Primiera Liga,MOZ,Forward,"22,500",20,2,0,2
3598,Inter,Serie A,ALB,Defender,"21,500",19,0,0,0
3599,Sassuolo,Serie A,ALB,Midfilder,"21,500",19,0,0,0
3600,Bologna,Serie A,ITA,Forward,"21,500",18,0,0,0
3601,Empoli,Serie A,ITA,Forward,"21,500",19,0,0,0
3602,Udinese,Serie A,ITA,Midfilder,"21,000",19,1,0,1
3603,Sassuolo,Serie A,ITA,Defender,"21,000",19,0,0,0
3604,VfB Stuttgart,Bundesliga,JPN,Defender,"21,000",18,0,0,0
3605,Leeds,Premier League,FRA,Forward,"21,000",18,0,0,0
3606,Bournemouth,Premier League,ENG,Forward,"21,000",19,20,0,20
3607,Bournemouth,Premier League,ENG,Goalkeeper,"21,000",19,17,0,17
3608,Bournemouth,Premier League,ENG,Defender,"21,000",19,4,0,4
3609,Bournemouth,Premier League,ENG,Midfilder,"21,000",19,7,0,7
3610,Newcastle,Premier League,SCO,Goalkeeper,"21,000",19,25,0,25
3611,Leeds,Premier League,ENG,Defender,"21,000",18,0,0,0
3612,Leeds,Premier League,ENG,Midfilder,"21,000",18,0,0,0
3613,Leeds,Premier League,SCO,Defender,"21,000",18,0,0,0
3614,Sampdoria,Serie A,ITA,Defender,"20,500",19,0,0,0
3615,Estoril Praia,Primiera Liga,UKR,Midfilder,"20,500",19,13,0,13
3616,PTM,Primiera Liga,BRA,Midfilder,"20,000",20,15,0,15
3617,VIZ,Primiera Liga,POR,Defender,"20,000",20,5,0,5
3618,Famalicao,Primiera Liga,NGA,Forward,"20,000",18,6,0,6
3619,VIZ,Primiera Liga,GNB,Goalkeeper,"20,000",19,0,0,0
3620,Gil Vicente,Primiera Liga,COL,Defender,"20,000",20,16,0,16
3621,Gil Vicente,Primiera Liga,ANG,Forward,"20,000",19,13,0,13
3622,VTSC,Primiera Liga,ANG,Forward,"20,000",18,0,0,0
3623,VIZ,Primiera Liga,BRA,Defender,"20,000",19,0,0,0
3624,VIZ,Primiera Liga,POR,Defender,"20,000",18,0,0,0
3625,Estoril Praia,Primiera Liga,POR,Midfilder,"20,000",19,21,0,21
3626,MRT,Primiera Liga,COL,Defender,"20,000",22,3,0,3
3627,P. Ferreira,Primiera Liga,POR,Goalkeeper,"20,000",20,7,0,7
3628,Estoril Praia,Primiera Liga,POR,Midfilder,"20,000",20,1,0,1
3629,MRT,Primiera Liga,MOZ,Defender,"20,000",22,1,0,1
3630,MRT,Primiera Liga,BRA,Forward,"20,000",20,5,0,5
3631,Estoril Praia,Primiera Liga,POR,Forward,"20,000",18,1,0,1
3632,BVT,Primiera Liga,POR,Midfilder,"20,000",18,0,0,0
3633,VIZ,Primiera Liga,POR,Defender,"20,000",18,0,0,0
3634,Estoril Praia,Primiera Liga,GER,Midfilder,"20,000",19,0,0,0
3635,VTSC,Primiera Liga,POR,Defender,"20,000",18,0,0,0
3636,VTSC,Primiera Liga,POR,Defender,"20,000",18,0,0,0
3637,MRT,Primiera Liga,COL,Forward,"20,000",22,5,0,5
3638,VIZ,Primiera Liga,POR,Defender,"20,000",18,31,0,31
3639,VIZ,Primiera Liga,NGA,Midfilder,"20,000",20,0,0,0
3640,Gil Vicente,Primiera Liga,POR,Forward,"20,000",22,39,0,39
3641,Parthenope,Serie A,ITA,Goalkeeper,"20,000",18,0,0,0
3642,Torino,Serie A,ROU,Defender,"19,750",19,0,0,0
3643,Bournemouth,Premier League,ENG,Midfilder,"19,500",19,11,0,11
3644,Udinese,Serie A,TUN,Defender,"19,500",19,1,0,1
3645,Empoli,Serie A,HUN,Defender,"19,250",18,2,0,2
3646,Sassuolo,Serie A,GUI,Midfilder,"19,250",19,0,0,0
3647,Verona,Serie A,FRA,Defender,"19,000",19,0,0,0
3648,Torino,Serie A,ENG,Defender,"19,000",19,0,0,0
3649,Inter,Serie A,DEN,Midfilder,"18,750",18,0,0,0
3650,Lazio,Serie A,POL,Goalkeeper,"18,500",18,2,0,2
3651,Juventus,Serie A,ITA,Defender,"18,500",18,28,0,28
3652,Spezia,Serie A,ITA,Midfilder,"18,250",19,0,0,0
3653,Salernitana,Serie A,POL,Defender,"18,250",18,0,0,0
3654,Sassuolo,Serie A,NED,Defender,"18,250",18,0,0,0
3655,Verona,Serie A,CIV,Forward,"18,250",18,0,0,0
3656,Spezia,Serie A,ITA,Goalkeeper,"18,250",19,0,0,0
3657,Atalanta,Serie A,ITA,Forward,"18,250",19,0,0,0
3658,Cremonese,Serie A,ITA,Midfilder,"18,250",19,0,0,0
3659,Salernitana,Serie A,LTU,Defender,"18,250",18,53,0,53
3660,Inter,Serie A,SVN,Defender,"18,250",18,0,0,0
3661,Torino,Serie A,ITA,Goalkeeper,"18,250",19,0,0,0
3662,Spezia,Serie A,ITA,Defender,"18,250",19,4,0,4
3663,Spezia,Serie A,ISL,Defender,"18,250",18,1,0,1
3664,Verona,Serie A,MAR,Midfilder,"18,250",18,4,0,4
3665,Sampdoria,Serie A,ITA,Defender,"18,250",19,0,0,0
3666,Fiorentina,Serie A,SEN,Forward,"18,250",18,0,0,0
3667,Atalanta,Serie A,ALB,Midfilder,"18,250",18,0,0,0
3668,Cremonese,Serie A,ITA,Midfilder,"18,250",18,24,0,24
3669,Empoli,Serie A,BEL,Defender,"18,250",18,0,0,0
3670,Udinese,Serie A,GHA,Forward,"18,250",18,0,0,0
3671,Nottm Forest,Premier League,ENG,Midfilder,"18,250",19,1,0,1
3672,Gil Vicente,Primiera Liga,UKR,Defender,"18,250",18,0,0,0
3673,Verona,Serie A,SUI,Forward,"18,000",18,10,0,10
3674,MRT,Primiera Liga,POR,Forward,"18,000",19,0,0,0
3675,MRT,Primiera Liga,POR,Midfilder,"18,000",18,6,0,6
3676,MRT,Primiera Liga,BRA,Forward,"18,000",22,11,0,11
3677,VIZ,Primiera Liga,POR,Forward,"18,000",20,0,0,0
3678,MRT,Primiera Liga,POR,Defender,"18,000",20,0,0,0
3679,Estoril Praia,Primiera Liga,POR,Forward,"18,000",18,0,0,0
3680,VIZ,Primiera Liga,NGA,Forward,"18,000",20,3,0,3
3681,VIZ,Primiera Liga,POR,Midfilder,"18,000",18,0,0,0
3682,MRT,Primiera Liga,ANG,Midfilder,"18,000",19,0,0,0
3683,Gil Vicente,Primiera Liga,POR,Defender,"18,000",21,24,0,24
3684,MRT,Primiera Liga,POR,Forward,"18,000",20,19,0,19
3685,MRT,Primiera Liga,POR,Forward,"18,000",19,10,0,10
3686,Gil Vicente,Primiera Liga,MAR,Defender,"18,000",19,0,0,0
3687,VIZ,Primiera Liga,POR,Defender,"18,000",19,0,0,0
3688,MRT,Primiera Liga,BRA,Defender,"18,000",18,0,0,0
3689,VIZ,Primiera Liga,NGA,Forward,"18,000",19,0,0,0
3690,MRT,Primiera Liga,POR,Forward,"18,000",21,5,0,5
3691,Famalicao,Primiera Liga,POR,Defender,"18,000",19,0,0,0
3692,MRT,Primiera Liga,POR,Midfilder,"18,000",20,1,0,1
3693,VIZ,Primiera Liga,POR,Defender,"17,500",20,0,0,0
3694,MRT,Primiera Liga,POR,Forward,"17,500",19,5,0,5
3695,MRT,Primiera Liga,POR,Forward,"17,500",18,3,0,3
3696,PTM,Primiera Liga,POR,Forward,"17,500",20,30,0,30
3697,MRT,Primiera Liga,POR,Forward,"17,500",19,10,0,10
3698,BVT,Primiera Liga,POR,Forward,"17,500",18,0,0,0
3699,Gil Vicente,Primiera Liga,POR,Midfilder,"17,500",20,3,0,3
3700,MRT,Primiera Liga,POR,Midfilder,"17,500",21,0,0,0
3701,MRT,Primiera Liga,POR,Defender,"17,500",21,0,0,0
3702,PTM,Primiera Liga,POR,Defender,"17,500",21,17,0,17
3703,Parthenope,Serie A,TUN,Forward,"17,250",19,0,0,0
3704,Sassuolo,Serie A,GHA,Midfilder,"17,250",19,0,0,0
3705,Valencia,La Liga,ESP,Midfilder,"17,250",18,10,0,10
3706,Vigo,La Liga,ESP,Forward,"17,000",21,63,0,63
3707,MRT,Primiera Liga,POR,Forward,"16,750",18,4,0,4
3708,VIZ,Primiera Liga,NGA,Forward,"16,750",18,0,0,0
3709,Gil Vicente,Primiera Liga,POR,Forward,"16,750",19,4,0,4
3710,Gil Vicente,Primiera Liga,POR,Midfilder,"16,750",19,0,0,0
3711,PTM,Primiera Liga,POR,Defender,"16,750",18,4,0,4
3712,Estoril Praia,Primiera Liga,POR,Defender,"16,750",19,0,0,0
3713,Estoril Praia,Primiera Liga,POR,Defender,"16,750",18,2,0,2
3714,Gil Vicente,Primiera Liga,POR,Goalkeeper,"16,750",20,2,0,2
3715,Estoril Praia,Primiera Liga,POR,Goalkeeper,"16,750",19,0,0,0
3716,Casa Pia,Primiera Liga,POR,Defender,"16,750",18,0,0,0
3717,VIZ,Primiera Liga,POR,Midfilder,"16,750",19,0,0,0
3718,Estoril Praia,Primiera Liga,POR,Midfilder,"16,750",19,0,0,0
3719,Gil Vicente,Primiera Liga,POR,Midfilder,"16,750",19,0,0,0
3720,Rio Ave,Primiera Liga,POR,Midfilder,"16,750",19,0,0,0
3721,VIZ,Primiera Liga,NGA,Midfilder,"16,750",19,0,0,0
3722,Gil Vicente,Primiera Liga,POR,Midfilder,"16,750",19,0,0,0
3723,VIZ,Primiera Liga,NGA,Midfilder,"16,750",19,0,0,0
3724,Torino,Serie A,ESP,Midfilder,"16,500",19,0,0,0
3725,Torino,Serie A,EST,Forward,"16,000",19,25,0,25
3726,Mallorca,La Liga,ESP,Defender,"16,000",18,0,0,0
3727,Vigo,La Liga,ESP,Midfilder,"16,000",18,2,0,2
3728,SC Freiburg,Bundesliga,EST,Defender,"16,000",18,0,0,0
3729,Brianza,Serie A,ITA,Forward,"15,750",19,0,0,0
3730,VIZ,Primiera Liga,CAN,Midfilder,"15,750",21,0,0,0
3731,VIZ,Primiera Liga,POR,Forward,"15,750",19,26,0,26
3732,Estoril Praia,Primiera Liga,POR,Defender,"15,750",19,0,0,0
3733,Estoril Praia,Primiera Liga,POR,Goalkeeper,"15,750",19,0,0,0
3734,PTM,Primiera Liga,POR,Forward,"15,750",18,0,0,0
3735,MRT,Primiera Liga,POR,Defender,"15,750",19,27,0,27
3736,VIZ,Primiera Liga,NGA,Forward,"15,750",18,0,0,0
3737,Estoril Praia,Primiera Liga,POR,Forward,"15,750",19,1,0,1
3738,Gil Vicente,Primiera Liga,POR,Midfilder,"15,750",19,1,0,1
3739,MRT,Primiera Liga,POR,Midfilder,"15,750",19,5,0,5
3740,Gil Vicente,Primiera Liga,POR,Midfilder,"15,750",19,5,0,5
3741,Gil Vicente,Primiera Liga,POR,Defender,"15,750",19,0,0,0
3742,MRT,Primiera Liga,POR,Goalkeeper,"15,750",19,7,0,7
3743,MRT,Primiera Liga,POR,Goalkeeper,"15,750",18,7,0,7
3744,MRT,Primiera Liga,POR,Defender,"15,750",18,4,0,4
3745,VIZ,Primiera Liga,POR,Defender,"15,750",18,0,0,0
3746,Rio Ave,Primiera Liga,POR,Defender,"15,750",19,0,0,0
3747,MRT,Primiera Liga,POR,Midfilder,"15,750",21,0,0,0
3748,VIZ,Primiera Liga,POR,Defender,"15,750",19,0,0,0
3749,Rio Ave,Primiera Liga,POR,Midfilder,"15,750",20,0,0,0
3750,VIZ,Primiera Liga,GHA,Defender,"15,750",18,0,0,0
3751,Gil Vicente,Primiera Liga,CAN,Goalkeeper,"15,500",18,0,0,0
3752,Valladolid,La Liga,ESP,Forward,"15,500",19,33,0,33
3753,Almeria,La Liga,GNB,Forward,"15,500",18,18,0,18
3754,A. Madrid,La Liga,ESP,Midfilder,"15,500",18,1,0,1
3755,Valladolid,La Liga,ESP,Midfilder,"15,500",18,15,0,15
3756,PTM,Primiera Liga,BRA,Goalkeeper,"15,500",20,0,0,0
3757,MRT,Primiera Liga,POR,Defender,"15,500",19,2,0,2
3758,A. Madrid,La Liga,ESP,Defender,"14,750",18,0,0,0
3759,A. Madrid,La Liga,MAR,Midfilder,"14,750",18,1,0,1
3760,1. FC Koln,Bundesliga,GER,Forward,"14,500",18,29,0,29
3761,Real San Sebastian,La Liga,ESP,Forward,"14,500",18,14,0,14
3762,Torino,Serie A,FRA,Defender,"14,500",18,0,0,0
3763,Famalicao,Primiera Liga,NGA,Forward,"14,250",19,20,0,20
3764,Verona,Serie A,ITA,Forward,"14,000",19,4,0,4
3765,Getafe,La Liga,ESP,Defender,"13,750",18,21,0,21
3766,Bologna,Serie A,HUN,Midfilder,"13,500",19,15,0,15
3767,Valencia,La Liga,ESP,Midfilder,"13,500",19,24,0,24
3768,Verona,Serie A,ITA,Midfilder,"13,500",19,0,0,0
3769,Rio Ave,Primiera Liga,POR,Defender,"13,500",19,0,0,0
3770,Gil Vicente,Primiera Liga,POR,Forward,"13,500",21,56,0,56
3771,MRT,Primiera Liga,DEN,Defender,"13,500",20,15,0,15
3772,Rio Ave,Primiera Liga,POR,Midfilder,"13,500",19,0,0,0
3773,Gil Vicente,Primiera Liga,POR,Goalkeeper,"13,500",19,0,0,0
3774,Rio Ave,Primiera Liga,SEN,Forward,"13,500",20,0,0,0
3775,Rio Ave,Primiera Liga,POR,Forward,"13,500",20,1,0,1
3776,MRT,Primiera Liga,MOZ,Goalkeeper,"13,500",18,0,0,0
3777,VIZ,Primiera Liga,POR,Midfilder,"13,500",18,6,0,6
3778,Sporting CP,Primiera Liga,BRA,Forward,"13,500",18,0,0,0
3779,Real San Sebastian,La Liga,ESP,Forward,"13,500",18,17,0,17
3780,MRT,Primiera Liga,POR,Defender,"13,500",19,7,0,7
3781,Gil Vicente,Primiera Liga,POR,Forward,"13,500",20,23,0,23
3782,Gil Vicente,Primiera Liga,POR,Defender,"13,500",19,0,0,0
3783,Gil Vicente,Primiera Liga,POR,Forward,"13,500",18,3,0,3
3784,Gil Vicente,Primiera Liga,GNB,Defender,"13,500",20,10,0,10
3785,Rio Ave,Primiera Liga,POR,Forward,"13,500",19,0,0,0
3786,Rio Ave,Primiera Liga,POR,Forward,"13,500",19,3,0,3
3787,Rio Ave,Primiera Liga,POR,Forward,"13,500",18,0,0,0
3788,MRT,Primiera Liga,POR,Forward,"13,500",22,19,0,19
3789,Rio Ave,Primiera Liga,TUN,Forward,"13,500",19,0,0,0
3790,FC Augsburg,Bundesliga,TUR,Defender,"13,250",18,3,0,3
3791,Valencia,La Liga,ESP,Midfilder,"13,000",18,0,0,0
3792,Valencia,La Liga,ESP,Forward,"13,000",18,2,0,2
3793,Valencia,La Liga,ESP,Midfilder,"13,000",18,0,0,0
3794,Valencia,La Liga,ESP,Forward,"13,000",18,0,0,0
3795,Girona,La Liga,ESP,Defender,"13,000",19,0,0,0
3796,Espanyol,La Liga,ESP,Forward,"13,000",18,0,0,0
3797,Cadiz,La Liga,ESP,Defender,"13,000",18,0,0,0
3798,Cadiz,La Liga,ESP,Defender,"13,000",18,0,0,0
3799,Valencia,La Liga,BUL,Goalkeeper,"13,000",18,1,0,1
3800,Real San Sebastian,La Liga,ESP,Defender,"13,000",18,2,0,2
3801,Elche,La Liga,ESP,Goalkeeper,"13,000",18,0,0,0
3802,Elche,La Liga,ESP,Defender,"13,000",18,0,0,0
3803,Elche,La Liga,ESP,Defender,"13,000",18,0,0,0
3804,Valencia,La Liga,ESP,Defender,"13,000",18,0,0,0
3805,Real San Sebastian,La Liga,ESP,Goalkeeper,"13,000",18,0,0,0
3806,Real San Sebastian,La Liga,ESP,Defender,"13,000",18,0,0,0
3807,Real San Sebastian,La Liga,ESP,Defender,"13,000",18,0,0,0
3808,Real San Sebastian,La Liga,ESP,Defender,"13,000",18,0,0,0
3809,Real San Sebastian,La Liga,ESP,Midfilder,"13,000",18,0,0,0
3810,Real San Sebastian,La Liga,FRA,Midfilder,"13,000",18,1,0,1
3811,Espanyol,La Liga,ESP,Forward,"13,000",18,0,0,0
3812,Atletico Pamplona,La Liga,ESP,Goalkeeper,"13,000",18,0,0,0
3813,A. Madrid,La Liga,ESP,Forward,"13,000",18,0,0,0
3814,Vallecano,La Liga,ESP,Goalkeeper,"13,000",19,0,0,0
3815,Getafe,La Liga,COL,Forward,"13,000",19,0,0,0
3816,Atletico Pamplona,La Liga,ESP,Defender,"13,000",19,5,0,5
3817,Elche,La Liga,ESP,Midfilder,"13,000",18,0,0,0
3818,A. Madrid,La Liga,ESP,Midfilder,"13,000",18,1,0,1
3819,A. Bilbao,La Liga,ESP,Defender,"13,000",18,0,0,0
3820,Girona,La Liga,ESP,Defender,"13,000",18,4,0,4
3821,Cadiz,La Liga,MLI,Defender,"13,000",18,1,0,1
3822,Espanyol,La Liga,ESP,Forward,"13,000",18,0,0,0
3823,Mallorca,La Liga,ESP,Forward,"13,000",18,2,0,2
3824,Espanyol,La Liga,LTU,Goalkeeper,"13,000",18,0,0,0
3825,Real Hispalis,La Liga,ESP,Defender,"13,000",18,0,0,0
3826,Mallorca,La Liga,ESP,Goalkeeper,"13,000",18,7,0,7
3827,Valladolid,La Liga,ESP,Midfilder,"13,000",18,22,0,22
3828,A. Madrid,La Liga,MAR,Forward,"13,000",18,0,0,0
3829,Valladolid,La Liga,ESP,Goalkeeper,"13,000",19,16,0,16
3830,Almeria,La Liga,USA,Forward,"13,000",18,0,0,0
3831,Elche,La Liga,ESP,Forward,"13,000",18,26,0,26
3832,Vigo,La Liga,ESP,Midfilder,"13,000",19,1,0,1
3833,Real Hispalis,La Liga,ESP,Midfilder,"13,000",18,0,0,0
3834,A. Bilbao,La Liga,COL,Goalkeeper,"13,000",18,0,0,0
3835,Vallecano,La Liga,ESP,Midfilder,"13,000",19,0,0,0
3836,Elche,La Liga,ARG,Forward,"13,000",19,0,0,0
3837,Cadiz,La Liga,ARG,Forward,"13,000",18,4,0,4
3838,Atletico Pamplona,La Liga,ESP,Midfilder,"13,000",18,0,0,0
3839,Valencia,La Liga,GHA,Midfilder,"13,000",18,0,0,0
3840,Valencia,La Liga,ESP,Defender,"13,000",18,0,0,0
3841,Elche,La Liga,ESP,Midfilder,"13,000",18,0,0,0
3842,Villarreal,La Liga,ESP,Forward,"13,000",18,0,0,0
3843,Cadiz,La Liga,ESP,Defender,"13,000",18,0,0,0
3844,A. Madrid,La Liga,ESP,Forward,"13,000",18,0,0,0
3845,Vigo,La Liga,POR,Defender,"13,000",18,0,0,0
3846,Almeria,La Liga,ESP,Defender,"13,000",18,0,0,0
3847,Espanyol,La Liga,ESP,Defender,"13,000",18,0,0,0
3848,Elche,La Liga,ESP,Forward,"13,000",18,0,0,0
3849,Villarreal,La Liga,ESP,Defender,"13,000",18,0,0,0
3850,VIZ,Primiera Liga,POR,Forward,"13,000",18,0,0,0
3851,MRT,Primiera Liga,POR,Midfilder,"13,000",20,0,0,0
3852,Getafe,La Liga,ARG,Goalkeeper,"13,000",18,0,0,0
3853,Villarreal,La Liga,ESP,Midfilder,"13,000",18,0,0,0
3854,Girona,La Liga,ESP,Midfilder,"13,000",18,0,0,0
3855,Cadiz,La Liga,ESP,Defender,"13,000",18,0,0,0
3856,Cadiz,La Liga,ESP,Midfilder,"13,000",18,0,0,0
3857,Vallecano,La Liga,ESP,Defender,"13,000",19,0,0,0
3858,Vallecano,La Liga,ESP,Midfilder,"13,000",19,0,0,0
3859,Vallecano,La Liga,ESP,Defender,"13,000",19,30,0,30
3860,Valencia,La Liga,ESP,Midfilder,"13,000",18,0,0,0
3861,Real Hispalis,La Liga,ESP,Defender,"13,000",18,0,0,0
3862,Real Hispalis,La Liga,ESP,Defender,"13,000",18,0,0,0
3863,Girona,La Liga,MAR,Defender,"13,000",18,0,0,0
3864,A. Bilbao,La Liga,ESP,Defender,"13,000",18,2,0,2
3865,Cadiz,La Liga,MLI,Forward,"13,000",18,0,0,0
3866,A. Madrid,La Liga,ESP,Defender,"13,000",18,0,0,0
3867,A. Madrid,La Liga,ESP,Midfilder,"13,000",18,0,0,0
3868,A. Madrid,La Liga,ESP,Midfilder,"13,000",18,0,0,0
3869,A. Madrid,La Liga,ESP,Defender,"13,000",18,0,0,0
3870,Elche,La Liga,ESP,Defender,"13,000",19,0,0,0
3871,Mallorca,La Liga,ESP,Midfilder,"13,000",18,0,0,0
3872,Sevilla,La Liga,ESP,Goalkeeper,"13,000",18,0,0,0
3873,Sevilla,La Liga,ESP,Defender,"13,000",18,1,0,1
3874,Sevilla,La Liga,ESP,Defender,"13,000",18,0,0,0
3875,Sevilla,La Liga,ESP,Defender,"13,000",18,0,0,0
3876,Sevilla,La Liga,ESP,Midfilder,"13,000",18,1,0,1
3877,Almeria,La Liga,NED,Goalkeeper,"13,000",18,0,0,0
3878,Valencia,La Liga,ESP,Defender,"13,000",18,0,0,0
3879,A. Bilbao,La Liga,ESP,Defender,"13,000",18,0,0,0
3880,PTM,Primiera Liga,BRA,Goalkeeper,"12,500",18,0,0,0
3881,Rio Ave,Primiera Liga,GNB,Forward,"12,250",19,0,0,0
3882,Rio Ave,Primiera Liga,POR,Defender,"12,250",18,0,0,0
3883,MRT,Primiera Liga,POR,Defender,"12,250",19,6,0,6
3884,MRT,Primiera Liga,POR,Defender,"12,250",19,7,0,7
3885,Rio Ave,Primiera Liga,POR,Midfilder,"12,250",21,0,0,0
3886,FC Porto,Primiera Liga,NGA,Forward,"12,000",22,41,2,43
3887,BVT,Primiera Liga,BRA,Defender,"11,750",22,10,0,10
3888,MRT,Primiera Liga,GNB,Defender,"11,750",20,10,0,10
3889,Salento,Serie A,ITA,Defender,"11,250",19,0,0,0
3890,Vigo,La Liga,ESP,Forward,"9,000",19,0,0,0
3891,Sampdoria,Serie A,ITA,Defender,"8,500",19,0,0,0
3892,Sporting CP,Primiera Liga,GEO,Goalkeeper,"7,500",18,6,0,6
3893,Leeds,Premier League,NOR,Midfilder,"7,500",18,0,0,0
3894,Vigo,La Liga,ESP,Defender,"5,750",18,0,0,0
3895,VIZ,Primiera Liga,GHA,Midfilder,"5,250",20,0,0,0
3896,P. Ferreira,Primiera Liga,NGA,Forward,"5,250",18,0,0,0
3897,Rio Ave,Primiera Liga,FRA,Forward,"5,250",18,0,0,0
3898,Rio Ave,Primiera Liga,ENG,Forward,"5,250",18,0,0,0
3899,Famalicao,Primiera Liga,BRA,Defender,"4,500",20,1,0,1
3900,Vigo,La Liga,ESP,Forward,"3,800",18,0,0,0
3901,Vigo,La Liga,ESP,Defender,"3,600",18,0,0,0
3902,Vigo,La Liga,ESP,Defender,"3,400",19,0,0,0
3903,Famalicao,Primiera Liga,BRA,Goalkeeper,"3,200",18,0,0,0
3904,Vigo,La Liga,ESP,Forward,"2,900",18,0,0,0
3905,Vigo,La Liga,ESP,Defender,"2,700",18,0,0,0
3906,Vigo,La Liga,ESP,Defender,"1,400",18,0,0,0
